text	label
Why this keyboard intercepting kernel extension doesn't work?	osx
How do I call an ORACLE function from OCI ?	oracle
Typed FP: Tuple Arguments and Curriable Arguments	haskell
Do I still need to learn about managing memory now that Objective-C/Cocoa has Garbage collection?	cocoa
"""Wordpress: wpdb->insert VERSUS wpdb->prepare(wpdb->query(""""INSERT..."""	wordpress
Handling metacharacters in search strings	bash
Sql server Newbie needs help	excel
Cabal and zlib on OS X	haskell
NSColor with calibrated values works differently than regular color??	cocoa
Little Bash Script: Catch Errors?	bash
Undeletable file due to backup script	bash
"""Creating """"pretty"""" Qt Custom Widgets"""	qt
Is there any way to only update added files?	svn
How to debug the main SafariPlugIn project ?	cocoa
Tips for using CVS or Subversion as a backup framework for office documents	svn
"""Per-filetype """"View whitespace"""" setting in Visual Studio"""	visual-studio
Query to Delete Posts Older than X Days in WordPress	wordpress
SharePoint Lists, GetListItems, XML, and VBA - I just want to crossreference!	sharepoint
What is GHCi's default implementation of MonadError?	haskell
Apache returns sitemap.xml not /sitemap	apache
QT question about a QList<QStingList>	qt
Running A Bash Script Over SSH	bash
Using CMS to make webapps.	wordpress
QTMovie Notification	qt
Unpacking varargin to individual variables	matlab
Using CoreData with an object?	osx
Thread safety of Matlab engine API	matlab
Qt +hiding window after startup	qt
Why does Spotlight sometimes not run my query?	cocoa
Creating a bundle - What's going wrong?	cocoa
Qt 4.5.3 QEvent::EnterEditFocus	qt
svn + repostiory location	svn
fatal error Varien_Autoload not found	magento
Sharepoint - Providing data outisde intranet	sharepoint
Is QuickSilver dead?	osx
"""""""Microsoft Visual C# IntelliSense has stopped working"""" in project referencing F#"""	visual-studio
Wordpress: How do I convert a generated URL (permalink) to a pretty URL?	wordpress
Visual Studio plug-in that mimics eclipse environment	visual-studio
Getting a List of Applications Capable of Opening a Type of File	osx
"""Cocoa Distributed Objects, Long Polling, lunchd and """"Not Responding"""" in Activity Monitor"""	cocoa
I want my wp 2.8.6 blog to be seen as written in Spanish by Feedburner.	wordpress
drupal search on the top taxnomy term	drupal
What to do with “Inferred type is less polymorphic than expected”?	haskell
Apache FOP: Displaying UTF-8 Characters in PDF (without embed?)	apache
Restrict access using SSL certs	apache
Does Scala's pattern matching violate the Open/Closed Principle?	scala
How to ensure AJAX encoding will work	ajax
CruiseControl.net : Using SvnLabeller / SvnRevisionLabeller	svn
Dimension Reduction	matlab
Reading/writing QObjects	qt
Hibernate NullPointerException In Loader Class	hibernate
QtPython: removeChild/addChild QGroupBox	qt
Visual Studio 2010 SP1 to 11 Beta - Unit Test Project Cannot be Loaded	visual-studio
What Confuses you about Magento Widgets?	magento
How to create the file browser in view for spring roo?	spring
Bash scripting problem	bash
Error: Attempted to access data(2,:); index out of bounds because size(data)=[1,7129].	matlab
Making Excel 2002 use .NET v2.0.50727 runtime	excel
"""VS2008 crashes with """"Fatal Execution Engine Error"""""""	visual-studio
Hibernate Computed Criteria Order	hibernate
Error: <target>.ColumnName and <source>.ColumnName have conflicting properties: DataType property mismatch.	excel
Trying to get rsync to copy files back to svn	osx
Turn off auto formatting in Visual Studio	visual-studio
Matlab - divide matrix elements by column sums.	matlab
Drupal: Which MySQL do I need?	drupal
How do I remove CSS from WordPress admin sections	wordpress
cd doesn't work when redirecting output?	bash
LinqDataSource and DateTime Format	linq
Wordpress, WP_Query with custom taxonomy and custom post type	wordpress
can you asyncronously notify a web browser?	ajax
Singleton Design	cocoa
Display Posts from a category in Wordpress?	wordpress
"""How does Apple make the info.plist display its """"Information Property List""""?"""	cocoa
changing search-dirs for $ sudo gcc	haskell
How to categorize Google Docs published as posts to Wordpress	wordpress
Resizing Mfc dialog with embeded QWinWidget	qt
linq subquery returning null	linq
Visual Studio - Prevent stopping debugging from closing Internet Explorer	visual-studio
A View Controller that can be instantiated both programatically and in IB?	cocoa
PL-SQL: getting column data types out of query results	oracle
how to express {2n+3m+1|n,m∈N} in list comprehension form? ( N is the set of natraul number including 0)	haskell
Mac Plugins no longer support GetWindowFromPort?	osx
including Qt headers in DLL	qt
Highlight colors in an NSTableColumn on highlight	cocoa
wordpress: actions, filters & hooks	wordpress
Sharepoint Blog: enable/disable comments regarding field value of Posts	sharepoint
Magento - blank lines being added to wsdl file	magento
Problem installing haskel-platform	haskell
numericupdown control	visual-studio
Short way of making many beans depend-on one bean	spring
Visual Studio vs. #Develop - Default event handlers	visual-studio
Hibernate mappings: Splitting up the file	hibernate
Creating object named after the value of an NSString - is it possible?	cocoa
Have you integrated Mantis and Subversion?	svn
How do you change the look of a check box?	cocoa
[Matlab] Saved EPS image different than plotted chart	matlab
newly installed apache serving html content as text	apache
"""Subversion ignoring """"--password"""" and """"--username"""" options"""	svn
"""Why does my web part throw an error about """"NT Authority/Anonymous User""""?"""	sharepoint
How to put more than 1000 values into an Oracle IN clause	oracle
What's XLSHTML?	excel
QMutex stuck in locked state	qt
Best Way to Ajax-Control Table Rows	ajax
Implementing Tiny MCE As Local HTML Editor	apache
Hibernate, instrumentation and delete cascade order	hibernate
Print certain tabs	excel
scala: 'def foo = {1}' vs 'def foo {1}'	scala
A general linux rights question: Apache and WordPress	apache
C framework like Qt ?	qt
Using Node Data after Node is Created	drupal
How to change tinyMCE editor's button's default tag output in wordpress?	wordpress
Oracle Analytics inside Cursor	oracle
Hibernate: unmapped class association exception	hibernate
How can I associate many existing files with drupal filefield?	drupal
linq question: querying nested collections	linq
Is there an efficiency penalty when using Scala inner functions within non-tail recursive functions?	scala
How do I get spring to inject my EntityManager?	spring
Gridlines in excel through interop	excel
LINQ-to-SQL and mass-changes submit very slow	linq
How to know the line of a bug in a spring generated bean ?	spring
adding oracle's timestamp to query results	oracle
Question about [[]], [] and $#	bash
Unable to enable jquery UI module in drupal??	drupal
How would you make a text cell in a an Outline View show how many children the parent row has?	cocoa
Ajax: Load XML from different domain?	ajax
Fill array with consecutive integers	excel
tortoise svn in system tray possible?	svn
linqtosql, timespan, aggregates ... can it be done?	linq
Using Visual Studio 2005 with ClearCase Eclipsed Files	visual-studio
With wordpress, is there a statement like current_user_can except show something if a user does not have specific access?	wordpress
yslow still not giving me an A for expires header in apache httpd even though I added them	apache
Java Swing or Java Qt?	qt
QT: reject() closing whole app? Why?	qt
Visual basic auto imports namespaces	visual-studio
"""MFC """"Warning: skipping non-radio button in group."""""""	visual-studio
Apache Tomcat 6 Problem Not Found(404)	apache
Excel form hides behind other windows after I browse for file but I want it to stay on top.	excel
How to add tracing within a for comprehension?	scala
'XMLHTTPRequest is Undefined' IE6	ajax
ListTemplateOwner	sharepoint
What is the best way of retrieving a specific post in Wordpress?	wordpress
What does the : infix operator do in Haskell?	haskell
PL/SQL: Problem in WHERE clause ( don't know how I can address results from DECODE() function in WHERE clause).	oracle
Updating live server from VCS	bash
Can one access TestContext in an AssemblyCleanup method?	visual-studio
How do I turn off Oracle password expiration?	oracle
Scala/Lift question rss feed fetch	scala
Haskell: What is the difference between $ (dollar) and $! (dollar exclamation point)	haskell
What should a longtime Windows user know when starting to use Linux?	bash
Case preserving find/replace in Visual Studio	visual-studio
Complex form design in Sharepoint	sharepoint
Multiple loop working, function inside isn't	wordpress
"""Wordpress Install: """"ERROR: you must provide an e-mail address."""""""	wordpress
Simple symlink in web root returns access denied	apache
Magento: Filter Configurable Product by their options	magento
Please explain what an outlook add-in is	visual-studio
Any disadvantages of accessing Subversion repositories through file:/// for a solo developer?	svn
svn ignore without deleting files?	svn
Plot data reconstruction reading pixel colors from image files	haskell
retrieve only sub-pages (wordpress)	wordpress
Adding more information onto the $user object in drupal?	drupal
Linq To Sql - ChangeConflictException not being thrown. Why?	linq
Comparing entities while unit testing with Hibernate	hibernate
Hibernate JPA Template fetch	hibernate
[Apache] RewriteRule removing trailing dot.	apache
"""Add app to the """"Startup Items"""""""	cocoa
"""Magento - Using alternative """"reviews count"""" on category list page"""	magento
After adding a symbolic link in a svn repository I keep receiving an error inside of that directory	svn
Reducing CPU processing time by using nice?	bash
Magento: Select the top ordered products	magento
"""SharePoint/WSS: Modify """"created by"""" field?"""	sharepoint
Sql Import wizard imports 1022868890 as 1.02287e+009	excel
When was <input type=search> introduced in Safari	osx
Generic-like behavior in PL/SQL procedure parameters	oracle
Combo Box Item comparison and compiler warnings	visual-studio
How to use spring to resolve dependencies of an object created manually?	spring
Get Max Date Using CAML Query From alist	sharepoint
Warning about bad shutdown preventing apache from running?	apache
Magento - link to a frontend skin js file from an admin file	magento
How do you set up drupal menues?	drupal
Ajax authentication without letting browser pop up login dialog	ajax
Excel Interop: Formatting Footers	excel
Center an NSView within an NSScrollView	osx
"""hibernate ignores fetch=""""join"""" on a collection when navigating the object tree with iterator"""	hibernate
Remove correctly selected NSManagedObjects	cocoa
Looping Variable Names	excel
OS/X mimetype handler	osx
How to use term_group for ordering subcategories in Wordpress?	wordpress
installing Lingotip translate on Magento; php version conflict; would like to override	magento
Mouse event is not detected on my NStableview + cocoa	cocoa
Smart tool (addin?) for creating class body from header file	visual-studio
Which view will be resolved, code from spring's docs	spring
Apache AllowOverride equivalent in Lighttpd	apache
Magento google checkout integration issue 404	magento
Scala objects not changing their internal state	scala
What is matlab good for? Why is it so used by universities? When is it better than python?	matlab
How to back up wordpress site to be restored after a clean installation	wordpress
How to prevent IE6 from refetching already-fetched images added via DOM manipulation	ajax
Why is App window only opening once and then not opening again?	cocoa
more efficent shell text manipulation	bash
Sub Query Where X in (from... ?	linq
Where do you define spring bean configuration files	spring
Cocoa Interface Builder's 'Attributes Inspector' like window	cocoa
Differing Apache Solr results when doing queries through Drupal – why?	drupal
Obtain a CGContextRef of NSView outside of drawRect ?	osx
Assign a taxonomy term to a view instance	drupal
Distinguishing between HFS+ and HFS Standard Volumes	osx
parser combinator: how to terminate repetition on keyword	scala
@Secured()      is there any statement show on log...?	spring
Showing 10 recent (same month/year?) items from a category (Wordpress)	wordpress
Qt, Signals without naming?	qt
Windows Mobile Device Emulator - how to save config permanently?	visual-studio
gdbinit conflict with Xcode debugging	osx
Replacing typelibs for imports	visual-studio
Visual Studio refactoring: Remove method	visual-studio
Using Makefile instead of Solution/Project files under Visual Studio (2005)	visual-studio
Is it possible to have a binding that combines more than one key path?	cocoa
Why does drupal_get_title() return empty on a Views page?	drupal
Magento - Have different set of fields and labels for cart and checkout (order review) screens	magento
Who are using all the memory on my production server(apache + mysql + rails) ?	apache
Scala, repeat a finite list infinitely	scala
Matlab - binary vector with high concentration of 1s (or 0s)	matlab
How to programmatically retrieve GHC package information?	haskell
Issue with database connection from sharepoint workflow with integrated security options	sharepoint
How do you give a text field a default font and some padding?	cocoa
Cocoa/Objective-C: how much optimization should I do myself?	cocoa
Wtf IE7 - AJAX calls using setTimeout	ajax
Are there any drawbacks to running Visual Studio remotely?	visual-studio
scala turning an Iterator[Option[T]] into an Iterator[T]	scala
Printing $node vars in page.tpl.php	drupal
How can I get XStream to output Scala lists nicely? Can I write a custom converter?	scala
Asp.NET Webpart > Userctrl > ClientScript.RegisterStartupScript not working!?	ajax
Hibernate Specific DDL Generation	hibernate
"""MATLAB """"C"""" DLL Errors"""	matlab
Analyzing data for noisy arrays	matlab
Oracle10 and JDBC: how to make CHAR ignore trailing spaces at comparision?	oracle
At what point do you need to be a programmer to work with Drupal?	drupal
[Visual Studio 2003] Setting environment variables in pre-build event and using in compilation step	visual-studio
Qt: Session Management Error	qt
How to create CommonsMultipartFile object given only a file.	spring
QtWebKit Manager	qt
Is there a way to control which implicit conversion will be the default used?	scala
Sharing Data Across Sharepoint Sites - Roll Up or Pull Down?	sharepoint
URL Redirection for SSL virtual hosts	apache
Paypal Standard option does not appear on the Checkout page	magento
How to scale a UIImageView proportionally ?	cocoa
JMeter command line - linux version vs windows version	apache
Rar command - ignore certain folders	svn
matlab: vectorized manipulation of cell array	matlab
Mixing Static Libraries of C Code  built from different versions of Visual Studio 2002 and later	visual-studio
Spring: I wish to create a junit test for a web application - WebApplicationContext needed	spring
Is this normal Magento memory behaviour	magento
Is there any game engine in Scala?	scala
Excel Replace all found chars	excel
Haddock losing part of the documentation?	haskell
Cross-Platform Objective-C / C++ Development	osx
"""Why does the """"choose files"""" button not work in Wordpress 2.5 when trying to upload photos?"""	wordpress
[macosx]does dlopen call open and read functions?	osx
Oracle: How can I programmatically arrange to have my current connection killed?	oracle
Visual Studio opens Development Servers for all websites in my project	visual-studio
"""Scala: How to define """"generic"""" function parameters?"""	scala
Should +initialize/+load always start with an: if (self == [MyClass class]) guard?	cocoa
LINQ, iterators, selecting and projection	linq
Back button functionality to webpage with form and search result + Ajax (ASP.NET)	ajax
Are AJAX sites crawlable by search engines?	ajax
Excel: Changing right click menu above autoshapes.	excel
What's the drupal way to define global constants?	drupal
Upgrading project to XCode 3.2 under Snow Leopard won't debug	osx
Simplifying a complicated Cocoa-Touch View Controller	cocoa
HTML anchor too pull all Sticky Posts ?	wordpress
can matlab catch signals from linux? SIGIO	matlab
DataContext.CreateDatabase Attribute problem	linq
Best Way To Get Started With Mac Development	osx
Retrieving All Of An NSTreeController's Objects.	cocoa
deserializing a json object through Lift-JSON	scala
python Qt: main widget scroll bar	qt
os x: sending mail to localhost	osx
Why does -[NSTextStorage replaceCharactersInRange: withAttributedString:] sometimes, sometimes not honor fonts in other character sets?	cocoa
Easy way to make a UILabel cover and exactly match contents of a UITextField?	cocoa
Are these lines an error or info in Apache's error log?	apache
what are  current_user_can () function parameters ?	wordpress
Apache+PHP write permissions on unix	apache
Get dimensions for dataset matlab, Size Function	matlab
haskell, chaining filters	haskell
JQuery selectors not finding class on elements in table created by an Ajax XHR in Ruby on Rails	ajax
Extending Sharepoint XSL template	sharepoint
Qt Visual Studio 2008 Add-in problem	qt
Updating the image of a NSStatusItem	cocoa
Are LinQ Queries above different LinQ providers possible?	linq
LINQ: Group by month and year within a datetime field	linq
Hibernate named query parameter	hibernate
Interesting usage of tar... but what is happening?	bash
Update father on interceptor	hibernate
Sharepoint form layout in VB	sharepoint
caching spring/hibernate webapp	spring
ModelAttributes  not accessible on jsp (Spring MVC)	spring
Have you ever used NSZoneMalloc() instead of malloc()?	cocoa
Having trouble writing my fmap	haskell
XAMPP and WAMP in the LAMP, whats the best ?	apache
Is there a spring lazy proxy factory in Spring?	spring
excel with an SAS engine	excel
Bash Script - Read Binary File	bash
C# structural highlighting in Visual Studio 2008	visual-studio
FTP not uploading last 4 bytes	bash
How should asp.net(mvc) server return error to jquery ajax call to be caught in error callback?	ajax
Creating a dual Mac/Win Autorun CD	osx
Why Can't I Include A Blog?	wordpress
Non generic IQueryable Enumeration Problem	linq
Excel pivot chart linear time-scale	excel
How do I transfer a local Magento install onto my live server?	magento
ref vs idref attributes in spring bean declaration	spring
How do I get wordpress to override a previous posts query?	wordpress
Scala: How do I dynamically instantiate an object and invoke a method using reflection?	scala
MagentoCommerce development environment domain issue	magento
Functions too fast? So they get skipped?	ajax
Retreiving widget data with MySQL query in WordPress	wordpress
drupal bootstrap script: how to get list of all nodes of type x?	drupal
"""Matlab: """"grouping mean"""""""	matlab
OSX: Get application windows + bounds	osx
How to eliminate stack trace when running Specs through SBT?	scala
Sharepoint FBA and IIS 6.0 Anonymous access	sharepoint
Testing simultaneous calls to transactional service	spring
Linq and comparing two date columns	linq
"""Visual Studio 2008 -- Can I change which """"add reference"""" tab is selected by default?"""	visual-studio
"""Minimal """"Task Queue"""" with stock Linux tools to leverage Multicore CPU"""	bash
DRUPAL: use tags as filter in Views	drupal
Trace an arrow toward a specific angle	matlab
understanding JasperReports and JRBeanCollectionDataSource...	hibernate
hibernate SELECT..WHERE.. IN (value1, val2...)	hibernate
What does the `forall` keyword in Haskell/GHC do?	haskell
Too many input arguments Matlab	matlab
Drawbacks to using Lift (Scala-based framework) for webservices?	scala
Exception thrown after processing onSubmitAction	spring
Writing SQL function with XQuery Parameters	linq
Subversion: Allow both svn based (passwd file) and windows domain authentication	svn
sharepoint search with variation site	sharepoint
Excel COM Add-In dialog interrupts script	excel
LinqtoSQL filter and order by syntax	linq
What is the optimal configuration for serving multiple projects with Subversion ?	svn
Which additional securities do you add to your open source cms installations?	wordpress
Magento Fatal Error: Call to member function getSku() on a non-object	magento
SQL query in tables side by side instead of one long table	ajax
mod_rewrite: Rewriting / to cgi script	apache
MATLAB: Can axes tick labels be accesed as text objects?	matlab
Remove elements by index in haskell	haskell
Best way to pass objects between controller actions in grails	spring
Can you display data from a database in a WordPress blog post?	wordpress
Add date without exceeding a month.	oracle
Many types of String (ByteString)	haskell
Oracle load spikes couple hours after startup.	oracle
When is image within the updateprogress control sent to client in asp.net ???	ajax
Magento My Account Layout XML Problem	magento
LINQ: Remove items from IQueryable	linq
Visual Studio opens default browser instead of IE	visual-studio
How to handle this exception?	haskell
I can't create New Project on Visual Web Developer 2008 Express	visual-studio
Proxy choices: mod_proxy_balancer, nginx + proxy balancer, haproxy?	apache
How do I create a Magento module or widget that will appear on the shopping cart page?	magento
Eclipse's Crtl+click in Visual Stdio?	visual-studio
Jar utility for the Java package org.apache.poi.hssf.usermodel.*	spring
How do I order subpages within my static ones in Wordpress.org 2.8.4 ?	wordpress
Properties editor design pattern?	qt
Oracle linux front end	oracle
How can I remove jquery from the frontside of my WordPress?	wordpress
Apache/nginx fine grained (per file) permissions?	apache
Upload File Directly to S3 with Progress Bar	ajax
Why this simple hibernate sample doesn't work?	hibernate
How to add url shortener API to wordpress posts links?	wordpress
hibernate     @GeneratedValue  correct?	hibernate
Use post tags for meta keyword content	wordpress
learning drupal fast track: how to create a stackoverflow clone?	drupal
Qt, Mouse skipping, not updating every pixel, mouseMoveEvent()	qt
How can I divide a bound array in parts that automatically fill the table?	cocoa
pboard types will be deprecated	cocoa
Magento: Extending a community module	magento
Hibernate, Null values and nativeSQL	hibernate
Do self: T => and this: T => have the same meaning when defining a trait?	scala
"""Ajax POST method converts my """"+"""" value in a string  to """" """" why?"""	ajax
What are patches used for in SVN?	svn
Hibernate multi user environment	hibernate
debug output of game objects in Haskell/Yampa and HOOD	haskell
Magento Store - Extensions Breaking Admin	magento
"""""""does not contain"""" in CAML ?"""	sharepoint
The logic behind MacOS's Exposé	osx
stringstream manipulators & vstudio 2003	visual-studio
In Haskell, how do I recursively manipulate a tuple and preappend a character to the first element in the tuple?	haskell
Need opinion regarding design/architecture of a web application	scala
Is there an alternative of ajax that does not require polling without sever side modifications?	ajax
bash: redirect (and append) stdout and stderr to file and terminal	bash
Problem with Autowiring & No unique bean	spring
Is there an open source Wordpress plug-in to implement Facebook/Twitter/OpenID/... authentication?	wordpress
Backup and Restore SSP on MOSS 2007 fails due to missing .mdf files	sharepoint
Testing HTTPS files with MAMP	osx
Designing Web services for AJAX Consumption	ajax
Bash variable expansion	bash
"""""""svnlook changed"""" encoding"""	svn
Oracle materialized view tuning	oracle
List sorting and ordering problem...	hibernate
Apache/Tomcat error - wrong pages being delivered	apache
How do I read or write GTK TreeStores from/to files?	haskell
another excel offset question	excel
Magento Store - Don't Send Newsletter Success Email	magento
Detecting https requests in php	apache
Firefox : Open XLSX file not saving file butn opening binary.	excel
Out-of-memory algorithms for addressing large arrays	matlab
Hibernate Mapping Conditional Many-To-One	hibernate
Matlab: Adding symbols to figure	matlab
cancel hibernate query	hibernate
How to create a binding for NSApp.dockTile's	cocoa
"""Recovering from an unfortunate """"svn copy"""""""	svn
Multiple RewriteConds and RewriteRule Stacked Together	apache
Using NSTask: app freezing after returning output	cocoa
Unit Testing Hibernate's Optimistic Locking (within Spring)	spring
Popup blocked, jquery window.open in success: AJAX? outside ok.	ajax
osx & windows development -- for newbies	osx
"""rails - """"apache cannot run because another program is using its port"""""""	apache
"""""""Hiding"""" linq classes inside a namespace?"""	linq
duplicate spring configruations being loaded?	spring
Apacahe Name Virtual Host with SSL	apache
Qt: Erase background (Windows Aero Glass)	qt
Bash Tool To Parse CSV files	bash
Facebook Game Function, Optimizin a Call, and Loading Bar	ajax
How to check whether your work on WP or WPMU ?	wordpress
InvalidMappingException  Hibernate mapping file...anybody can you give resolution	hibernate
what is the best strategy  to retrieve form data? client ajax / server	ajax
??? Error using ==> dlmread at 55 Filename must be a string.	matlab
renaming current module	haskell
In Haskell, will calling length on a Lazy ByteString force the entire string into memory?	haskell
Netbeans scala plugin - no documentation	scala
Is it possible to access the previous/current value of a proxy object using KVO?	cocoa
Magento: find products without images (no image)	magento
Update Files in Sharepoint Document Library	sharepoint
Multiple Session Factories under Spring/Hibernate	hibernate
Why is Apache seg faulting?	apache
MaskedEditValidator DisplayMoney doesn't show up in Composite Control	ajax
VisualStudio immediate window command for Clear All	visual-studio
In Haskell, is there (Num a) => infinity :: a ?	haskell
Sharepoint Code Generation Tool	sharepoint
Using SharpSvn to retrieve log entries within a date range	svn
"""Hibernate Criteria API equivalent for """"elements()"""""""	hibernate
Cannot Access http://<tfs-server>:8080	visual-studio
Bubble sort algorithm implementations (Haskell vs. C)	haskell
"""Magento Complex Attribute: Value(s) = (Drop-Down item + Text Field input), and need an """"Add Another"""" button."""	magento
"""what is the real version for """"Apache/2.0.63 (Unix)"""" in a HTTP response header?"""	apache
How to install system packages into oracle?	oracle
Sub second request time logging	apache
What's event that Visual Studio 2008 do after post build event?	visual-studio
Keep a stream from fstream open through member functions	qt
Redirect requests only if the file is not found?	apache
Hibernaqte exception :org.hibernate.exception.SQLGrammarException: could not execute query	hibernate
Sharing memory between processes [matlab]	matlab
"""Operating on a return from a Maybe that contains """"Just"""""""	haskell
Very large drupal page execution time	drupal
"""cvs2svn fails with """"xxx is not a valid ,v file"""""""	svn
Help need Pls.... excel macro: compare and copy between worksheets	excel
Cocoa Won't Capture Shift Modifier?	osx
find natural block size of the media being used by file handle	cocoa
How do I use Data.Concurrent.mergeio?	haskell
Magento createBlock method not working, displaying static block data	magento
Zip Code distance in excel	excel
iTunes Plugin Programming: Intercept Events	osx
svn switch --relocate not persisting	svn
"""Is there an open-source SQL database that has the concept of Oracle's """"rowid"""" pseudo-column?"""	oracle
Why library name gets an additional 0 is its name?	qt
Filter Magento collection but not products, using distinct	magento
"""Oracle, calling PL/SQL issues from within SQL-Plus file x.sql says my_function """"may not be a function"""""""	oracle
What happens when I call QWidget->close()	qt
joining dots of scatter plot and create line	matlab
Code Promotion: Build or Binary?	svn
Graphing special functions in Matlab (2D Bessel)	matlab
Two approaches of task distribution in a multi tier application	spring
"""Does """"Select New"""" in linq trigger an evaluation / load?"""	linq
How do I draw a badge on my Dock icon using Cocoa?	cocoa
QT Model/View programming with complicated data structures	qt
Sharepoint Search Property Weighting	sharepoint
Hibernate: Why @OneToMany with List<MyClass> fails?	hibernate
LinqToSql - Multiple subqueries creates many roundtrips	linq
How can I send an array to php through ajax?	ajax
c++ for loop vs foreach	qt
How to implement pagination is spring mvc 3	spring
APACHE-TOMCAT can anybody elaborate which one is web-server and web-container?	apache
Getting data from sharepoint into drupal	drupal
System.Data.OracleClient: How can I mock/fake/stub OracleException?	oracle
Excel Range describes a group of adjacent cells.  When several groups of non-contiguous cells are selected, how do you get them all from Worksheet.Selected (range)?	excel
Why are my file permissions on Apache being reset?	apache
How do I specify types for Haskell's set builder notation ?	haskell
VSeWSS Administrator Privileges and <SafeControl> entry	sharepoint
<on-start> Expression	spring
Loading users from an SQL query - the correct way	drupal
Are subversion externals an antipattern?	svn
why doesn't scalac optimize tail recursion?	scala
"""Creating """"holey"""" median filter in Matlab"""	matlab
excel macro that checks every row has unique or blank number	excel
Presenting code on my personal website	svn
"""Preventing form_token from rendering in """"GET"""" forms"""	drupal
NSButton default button with blueish look	cocoa
Parent category as a mainmenu and sub category as a submenu in wordpress	wordpress
Apache setting mod_auth_ldap require settings per sub-directory	apache
How to tranform an Oracle SQL into a Stored Procedure that should iterate through some tables fetching a certain data field?	oracle
Bash+cron: Redirecting, and restoring, stdout and stderr produces permission denied	bash
Flex + Spring + BlazeDS + Glassfish + OpenMQ - How do you configure the web-application-config for OpenMQ?	spring
Using wp_query to pull content from a specific post using either title or id	wordpress
Magento 'loses' categories when entering a subcategory.	magento
getting new file added to subversion with updating whole folder	svn
Should I upgrade to Intellij Ultimate Edition?	scala
Apache Webserver security and optimization tips	apache
DataContext Refresh doesn't invoke PropertyChanging & PropertyChanged Events	linq
"""Should """"to-many"""" relationships be modelled as properties?"""	cocoa
Ordinal Weekday Suffix Option for NSDateFormatter setDateFormat	cocoa
Acessing other webapps while one is in document root	apache
template method pattern	spring
Get Directory Structure using Linq?	linq
Delegate methods of NSTextField using NSNotification	cocoa
HQL Join Fetch question: aliasing association	hibernate
Framework goto definition shows comments, are these generated from xml comments?	visual-studio
How to count rows in Lift (Scala's web framework)	scala
Subversion: Retract Accidental Checkin	svn
"""Mass Update Magento Field to """"Use Default Value"""""""	magento
tformfwd and tforminv - what's the difference?	matlab
xmlhttprequest onlys gets to status 3	ajax
ADO.NET Data Service not dynamically updating	linq
macports confusion	osx
jQuery Post failing on production, works on local system	ajax
MOSS (SharePoint) publishing page schedule options not appearing	sharepoint
Platform or tools for merging & filtering spreadsheet data online?	excel
Is it possible to target just Simple Product from phtml template?	magento
Cmdline Bash Variable Weirdness	bash
Compress a Mysqldump that is SSH'd to another machine	bash
if i have Windows, Mac, and Linux, what is the easiest way to set up SVN server?	svn
How to Deploy a Drupla Site on a Web Farm ?	drupal
XML Comments: To Use or Not To Use?	visual-studio
"""Magento flat product table - retrieving """"Most Viewed"""" product names"""	magento
LINQ asp.net page against MS Access . .	linq
Disable Apache 503 response when Tomcat is down	apache
Garbage collection of Core Foundation objects	cocoa
Server side svn branch reintegrate	svn
Useful Add-In's or Plug-In's for native Visual Studio developer	visual-studio
Qt: Do events get processed in order?	qt
graph database to store several time based data values, result of simulation	scala
(N)Hibernate: core/master mappings with relationships	hibernate
Uninstall Sharepoint Infrastructure Update	sharepoint
install EventFilter on QWidget (qt4.4.3/kde4)	qt
How do I fix the height of my view after collapsing NSSplitView?	cocoa
NSStatusItem to be always left?	cocoa
Is there integer ranges for Where Clause?	oracle
Content Taxonomy along with Conditional Fields	drupal
Apache RewriteRule .* index.php [NC,L] Not working	apache
MOSS 2007: SPListItem.GetFormattedValue for DateTime fields has a bug?	sharepoint
Adding a subview below my UITableView	cocoa
spring - use both simple SimpleUrlHandlerMapping and AnnotationMapping	spring
Unit Test to verify object getting deallocated	cocoa
"""How can I categorize the content types on the Drupal """"Create content"""" page (/node/add)"""	drupal
Linq 2 SQL: Setting ObjectTrackingEnabled to false breaks lazy loading of child entities?	linq
"""What does the """"Generate Validation Methods"""" checkbox in the Managed Object Class Generation dialog do?"""	cocoa
ORA-28579: network error during callback from external procedure agent	oracle
customize Finder 'get info' window?	cocoa
"""In Visual Studio 2008, how can I make control+click do a """"Go To Definition""""?"""	visual-studio
@OneToOne getting returned as ManyToOneType	hibernate
Matlab subclassing question	matlab
"""i am looking for svn admin like """"VisualSVN Server"""" for remote server?"""	svn
Unit testing code that uses PortalSiteMapProvider	sharepoint
Making Category Image a link	magento
How do I make Ajax calls at intervals without overlap?	ajax
Visual Studio Performance with External Hard Drive	visual-studio
How do I setQueryTimeout on SimpleJdbcTemplate?	spring
"""Apache configuration help -- Why are different processes """"in"""" different time zones?"""	apache
How do you build a debug .exe (MSVCRTD.lib) against a release built lib (MSVCRT.lib)?	visual-studio
Unresponsive Cancel Button on VBA Userform	excel
IP Blocking URLs on Apache	apache
"""Object converting string into """"A"""""""	scala
how do i check for errors in spring - security ?	spring
prototype - Replace & with &amp;	magento
Connect to my Repository remotely using TortoiseSVN	svn
"""How do I add  a """"last"""" class on the last <li> within a Views-generated list?"""	drupal
Add Solution Folder for VS 2008?	visual-studio
What is the maximum password length in Subversion?	svn
Setting global_names parameter.	oracle
Making a NSPopUpButton display all my iCal Calandars.	cocoa
JavaScript - How do I call a function from a string name and pass an array object?	ajax
WP Function to retrieve database connection	wordpress
Cannot see my drupal page, when set with online server.	drupal
QGraphicsView accepted events	qt
ScriptResource.axd requests return HTTP 302	ajax
Any reason to use NSViewAnimation over CoreAnimation techniques?	cocoa
excel file too big , which format to convert to imporve processing time in scripting	excel
MacBook Trackpad Gestures: Move active Window	osx
Ant-Ivy-Scala Template: any suggestions on improvements?	scala
Webserver Log Analysis	apache
Generate syntax-colored, hyperlinked source code from Haskell or Objective-C	haskell
SIGPIPE Exception	cocoa
Redirect certain requests if referer not from same page?	apache
what is this widget called?	qt
Installing Svn 1.5.x on Debian Etch - Best approach?	svn
Apache log analyzer which outputs user flows	apache
Oracle 10g ODBC: SQLBindParameter(SQL_BIGINT) succeeds, SQLExecute fails, but there are no diagnostic errors	oracle
Identifying Different Excel File Formats	excel
Expanding mySQL query to include more content	drupal
Is there sth like Microsoft's TechNet or MSDN subcriptions for Apple, too?	osx
Anybody using Qi4J	spring
Bash script directory detection and creation	bash
Retrieving the associated shared service provider's name?	sharepoint
Per language settings in Visual Studio 2008	visual-studio
Matlab: avoiding memory allocation in mex	matlab
Rewrite spring-security redirect URLs	spring
Solution: Per application, or per application suite.	visual-studio
Dynamic height for AJAX Autocomplete Textbox	ajax
Is it possible to set-up a personal SVN Remote Repository which can be accessed through the Internet?	svn
DataContxet reusing connection	linq
Matlab matrix replacement assignment gives error	matlab
bash/sh single-quote, doublequote & backquote question	bash
How to upload a file using asp.net without posting the whole page back?	ajax
Why doesn't this type declaration work?	haskell
A way to add Oscommerce cart items to a Wordpress Widget	wordpress
Disable Option-Enter line breaks in NSTextField?	cocoa
Debugging sometimes very slow	visual-studio
Compiling code on an external drive	visual-studio
Disable/Cancel Sleep Command on MacOSX	osx
Creating Cocoa PopUpMenus programatically and Getting code form a GUI item built with the interface builder	cocoa
identity from sql insert via jdbctemplate	spring
SEO for a Magento multilingual store	magento
After setting up the svnserve Server, what URL will the client use to access the server?	svn
Change background of QTabBar tabs using stylesheets	qt
What are your favorite programming-related academic papers?	haskell
Programmatically marking an Oracle BPEL task complete	oracle
.net solution subversion best practices?	visual-studio
Matlab: evaluate symbol expression	matlab
Trouble stopping Tomcat due to apparent threading issue..	spring
"""Drupal is unable to create the """"files"""" folder (and any upload php script as well)"""	drupal
Hibernate-like framework for C++	hibernate
Fba roles with SharePoint user groups	sharepoint
Use NSArrayController with nested NSMutableArrays (Cocoa Bindings Question)	cocoa
Has anyone here worked on KOFAX-SharePoint 2007 integration?	sharepoint
Matlab GPU acceleration for loading large point cloud dataset	matlab
Which pattern does Hibernate follow?	hibernate
What's an easy way to obtain the current svn revision in a c++ visual studio application	svn
Hibernate3: Self-Referencing Objects	hibernate
Redirecting from pubilc_html to public_html/new/	apache
Instance of fractional [Char] required for definition?	haskell
Visual Studio identical token highlighting	visual-studio
Calculating hdiutil's compression ratio	osx
Can Ruby on Rails connect to Oracle/RDB on Mac OS X or Windows?	oracle
Forcefully trigger a rule in Drupal?	drupal
Scala: can't write setter without getter?	scala
Apache mod-proxy load balancer maintenance	apache
"""""""Magento Tax Zones & Rates"""": how to incorporate store location and price dependencies for Tax Rates"""	magento
Magento module - overridden a controller, adding templates	magento
"""Magento - use an alternate """"price.phtml"""" (in addition to the existing one)"""	magento
automatically processing contents of <textarea> without user pressing a button	ajax
Bash script for manual routes and default gateway problem	bash
Mixing Static Strings with Views Arguments	drupal
Linq - Excluding items from different list types.	linq
Niewbie OutOfMemory problem	scala
Scala API design; a service which returns a Set<I> where I is some interface (abstract/trait)	scala
Good Alternatives to Visual Studio Setup Projects	visual-studio
XAMPP on Falshdrive cannot start Apache, MYSQL on WIndows 7	apache
Debugging NSObjectInaccessibleException - The NSManagedObject with ID:0x123456789  has been invalidated	osx
Magento - Changes to Edit Account Information screen do not get reflected	magento
awkward monad transformer stack	haskell
how covert post into othe language in wordpress?	wordpress
"""is this true? """"Gzipped items will not have the same etags (even if the content did not change)"""""""	apache
How to create a custom EL expression handling regime for jBPM	spring
"""Is there any way to programmatically """"move"""" an oracle table definition from one database to another?"""	oracle
removing some rows based on criteria - solving this by pivot tables	excel
Disable Trinidad skins	apache
No error message available, result code: E_FAIL(0x80004005)	excel
Hidden Features of Visual Studio (2005-2008)?	visual-studio
Sharepoint as template application	sharepoint
A project with output type of class library cannot be started directly - with a startup exe	visual-studio
Assigning random colors per session, for chat	ajax
Define Self referencing scala class(recrusive class)	scala
Microsft Enterprise Search - FAST	sharepoint
Plot Overlay Matlab	matlab
On MAC O.S., how to get the name of files that has been dropped onto apple script to boot JAR with the name of file as a argument to JAR	osx
Excel changes date formats	excel
issue in ajax modal pop up control when  used  witih listbox  control[which is of  a javascript]	ajax
Excel: need help with unusual lookup function (sorted column is different from lookup column)	excel
Why is it allowed to write to / on MacOSX as normal user?	osx
What programming task provided your breakthrough with monads?	haskell
CSS breaks in Explorer (insert humor here)	wordpress
Compiling Matlab to C# Problem: fatal error C1083: Cannot open include file: 'windows.h'	matlab
"""apache: cgi links lead to a """"you have chosen to open foo.cgi"""", although scriptalias is set"""	apache
Matlab matrix translation and rotation multiple times	matlab
"""Is do-notation specific to """"base:GHC.Base.Monad""""?"""	haskell
Best branching stragetgy when doing continuous integration?	svn
The Current State Of Serving a PHP 5.x App on the Apache, LightTPD & Nginx Web Servers?	apache
Nested Linq crashes intellisense	linq
"""Bash Scripting """" [!: not found """" errors, and how to write an or statement"""	bash
"""WordPress: I got rid of the second """"home"""" page, but it's not good enough"""	wordpress
What setting might be causing an AMP server to only allow 1 request at a time per browser?	apache
How to get Enumeration  Value's Enumeration definition?	scala
Notifying subclass of QAbstractItemModel about changes	qt
"""In Haskell, what does it mean if a binding """"shadows an existing binding""""?"""	haskell
Apple PhotoSearch Example Code - Need Help.	cocoa
linq cache and disposing datacontext	linq
Any feeback on the lib Ajax-Cross-Domain and the Jquery patch  ?	ajax
Wrapping Current Category Text with Span in Wordpress	wordpress
Synchronizing Sharepoint and Active Directory Groups?	sharepoint
To use or not to use the user module	drupal
Vim style folding for CSS/javascript in Visual Studio	visual-studio
WCF service with Qt?	qt
Default radio button not triggering an UpdateControl postback	ajax
Credit card processing between Magento & Oracle	magento
HQL Order by qurey giving problem	hibernate
Get WordPress Post ID from Post title	wordpress
Which CMS do I need? Needs to be easy to post a certain kind of post	wordpress
Silently modifying nodes	drupal
How do I write StoredProcedure sub-classes to call Oracle functions?	spring
DESCRIBE via database link?	oracle
How to define accessor method for default constructor parameter?	scala
Suggestions for Fun Web Programming Projects at Home	apache
user group gets page access	magento
link error when using boost library on MacOSX	osx
How do I use an NSFormatter subclass with an NSPopUpButton	cocoa
Scala: How can I implement a clone method on a superclass, and use it in a subclass?	scala
QT Eclipse Integration - Adding External Libs	qt
How to define a cyclic type definition?	scala
Compiling MatLab 2009b applications to Windows Executables	matlab
Moving MOSS Shared Service Provider	sharepoint
Explain Plan Cost vs Execution Time	oracle
nswindowcontroller	cocoa
Oracle compile view sql	oracle
ORM for ASP.net, ORACLE, looking for a solution.	oracle
DB backup problem with Spring/Hibernate GenerationType.AUTO	spring
Hibernate Immutable Value Object	hibernate
Haskell: Dealing With Types And Exceptions	haskell
Core data, NSArrayContainer Arraycontent of many arrays	cocoa
QT creator/qt embedded widget demo problem	qt
Mac Pro 64-bit addressing kernel	osx
Why doesn't intellisense show the appropriate methods according to what I am passing in?	visual-studio
How can i have two concurrent web apps running on VS2008/VSS8.0/ASP.NET/IIS for a trunk and branch version?	visual-studio
Scriptaculous autocompleter problem	ajax
SharePoint 2007 - How To Change Attachment Paperclip Image	sharepoint
Oracle table change monitor	oracle
Matlab - having trouble with subarray	matlab
Visual Studio 6 Processor Pack compatibility	visual-studio
Making A Menu Item Display A Window.	cocoa
Accesing A NSArray.	cocoa
If you use https will your url params will be safe from sniffing?	apache
"""Why would Visual Studio/CLR produce a """"bad"""" executable?"""	visual-studio
Object Model Permission	sharepoint
How does transaction propagation work when using Open Session In View?	spring
mod_rewrite: setting GET depending on HTTP_HOST	apache
Unix commandline history substitution ^foo^bar (for multiple replacements)	bash
EntityManager.merge inserts duplicate entities	hibernate
Changing font for member variables in Visual Studio	visual-studio
Managed Source Control Hosting and Continuous Integration with CVSDude and CruiseControl.net	svn
install haskell cabal w/o manual dependency resolution	haskell
This is asking a lot, I know, but: Help me translate this Glossary plugin for WP	wordpress
BAsh Script -- logname validation	bash
"""how to  find and clean wordpress from script/s that changes your blog posts titles on Google and yahoo with embarrassing """"Vigra  text""""?"""	wordpress
OS X: creating or extracting preview(.jpg,.png) of .eps file	osx
User Privileges	oracle
Always get exception when trying to Fill data to DataTable	oracle
Break Polyhedron into Tetrahedron	matlab
Easy Way to Find Images Used in a Wordpress Post?	wordpress
Can Multiple Indexes Work Together?	oracle
is there an argument to know you're on a views list page?	drupal
Excel: Cannot Delete Pesky Drop Down from Sheet	excel
PCRE format to QRegexp format	qt
Slow selection in QTreeView, why?	qt
What is the best way to make files live using subversion on a production server?	svn
Pretty Print Excel Formulas?	excel
Identifier for win64 configuration in Qmake	qt
Custom Build Numbering in Visual Studio	visual-studio
alternative to update_option() in wp-admin	wordpress
Haskel Hello world, exclipse IDE	haskell
svn import adds and commits a dir,but dir cant be browsed..	svn
Getting Cabal to work with GHC 6.12.1	haskell
how to integration test a DAO built with spring + iBatis	spring
How do I get ALL posts in a category with Wordpress?	wordpress
Migrating MOSS 2007 from SQL 2000 to SQL 2005	sharepoint
hibernate:  foreign key is primate key	hibernate
start php, apache?	apache
UNDOTBS Tablespace is Full what now?	oracle
Exception thrown in a referenced .dll how do I debug?	ajax
Drupal: cck taxonomy field with depth filtering	drupal
I want to create blog posts to drupal by sending messages through Outlook. Ideas??	drupal
Apache Django Mod_Wsgi Sessions Development Enviroment	apache
Why am I getting this error, when it cannot be true?	cocoa
Magento - Email Shipment = Default	magento
WAS 6.1, Hibernate, Spring and transaction managmement configuration	hibernate
Why do associated collections contain null values? (Hibernate, Annotation, Spring)	hibernate
What is your workflow for creating websites based on WordPress?	wordpress
"""How to """"white label"""" spring beans"""	spring
Sorting objects based on Double values?	scala
"""stackoverflow """"Related Questions"""""""	ajax
404 Problem Running Visual Studio ASP.NET Unit Test	visual-studio
DRUPAL: tags for CCK fields ?	drupal
Interpolating 1D Gaussian into 2D Gaussian	matlab
Left outer join fetch doesn't fill map collection properly (HQL)	hibernate
Cross Platform C library for GUI Apps?	qt
Quartz display services replacement for deprecated functions?	osx
Create a tag upon every build of the application?	svn
Drop into interpreter during arbitrary scala code location	scala
Bash loop - tokenize on lines rather than words	bash
Apache Alias problem, Snow Leopard	apache
Center block element in element	wordpress
Auto-redirect requests from /dirname to /dirname/	apache
hibernate cascade deletion  example	hibernate
odp.net tracing	oracle
Combining Structures	matlab
VS2008 setup project installing extra dependency files	visual-studio
Bazaar (bzr) integration with Visual Studio	visual-studio
Magento - Buy X Get Y Free - Realistically, Buy one get one free BOGOF	magento
"""magento """"gender"""" default option need change"""	magento
What would this sql query (w count and group by) look like when translated to linq?	linq
"""Using linux """"cut"""" with stdin"""	bash
Import files directly to SVN repo without checking out first	bash
HTML Form/Database query	ajax
TransactionScope, linq and strange transaction manager issue (HRESULT: 0x8004D024)	linq
What to keep in mind when making Wordpress themes	wordpress
VS2010 Extensibility - how different is it?	visual-studio
Solving drupal database entry dependancy problem?	drupal
Rails: submit (via AJAX) when drop-down option clicked	ajax
Can you return an assignable lvalue in Scala?	scala
XMLHttpRequest vs Socket vs ?	ajax
localhost working 127.0.0.1 broken in Safari	osx
go back to last state ajax pages?	ajax
hibernate - component mapping vs custom value type	hibernate
How do you flip the coordinate system of an NSView?	cocoa
Upgrade hibernate-annotations and hibernate-validator	hibernate
Newbie QT question about connect	qt
Cocoa MAC - problem with this code using NSBundle	osx
Can I transform this asynchronous java network API into a monadic representation (or something else idiomatic)?	scala
drupal taxonomy term path to return alias	drupal
Why is flatten declared on GenericTraversableTemplate?	scala
Errors creating WebPart subclass in another assembly	sharepoint
TSVNCache.exe is heating up my Mac	svn
"""Script puzzle <script src=""""ajaxpage.php?emp_id=23"""" /> ?"""	ajax
Neural network XOR backpropagation info needed.	matlab
Magento - Use Short description for Google base description	magento
"""Is it recommended to always have exhaustive pattern matches in Haskell, even for """"impossible"""" cases?"""	haskell
What does IAlertNotifyHandler's OnNotification() return value do?	sharepoint
Matlab Polymorphism question	matlab
ajax library that populates multiple fields	ajax
SwarmCache Hiberanate configuration	hibernate
Close client connection preaturely with apache/mod_perl	apache
Which delegate method I should use When I cliked on a textfield?	cocoa
Parse DS_Store w/ PHP	osx
Sharepoint workflows does not start	sharepoint
Objective-C Asynchronous Web Request with Cookies	osx
How do you combine filter conditions	haskell
Cannot integrate custom widgets dll into Qt designer	qt
Magento - change address to which confirmation is sent after newsletter subscription	magento
Drupal: updating with Drush doesn't change update status	drupal
Hibernate Auto Increment ID	hibernate
Already have MSDN with Team System Test edition, how do I....	visual-studio
drupal multiple node forms on one page	drupal
Scala: how can I sort an array of tuples by their second element?	scala
How update oracle heterogeneous services metadata?	oracle
Set parent's status bar text?	qt
WP-Contact Form 7 -- PHP Question	wordpress
Linq To SQL caching VS multi-user application.	linq
What does it mean when AuthorizationExecuteWithPrivileges() returns -1?	osx
hibernate ehcache only finding 1 element of a collection	hibernate
Bash output as Applescript list problems.	bash
image uploading using MultiPart	spring
SVN (mod_dav) 403 FORBIDDEN OPTION request	apache
"""Ajax Asynchronous in IE - Error """"The Data Necessary to Complete This Operation is Not Yet Available"""""""	ajax
Inheriting std::istream or equivalent	qt
Limit a double to two decimal places	cocoa
Matlab Magical Mystery timing behavior	matlab
sharing mysql conntection between php files	ajax
QTCreator's integrated form editor won't load custom widget plugins (Designer does)	qt
On Cygwin, how do I install curl from hackage?	haskell
QTableView - what signal is send when user selects a row by clicking to it?	qt
Lazy loading...	hibernate
Replace MacPorts dependency with other package	osx
Linq Efficiency question - foreach vs aggregates	linq
RA-AJAX download anywhere?	ajax
Apache/PHP closes connection after short time (12 secs)	apache
Preserve ls colouring after grep'ing	bash
Is it possible to specify an anonymous function's return type, in Scala?	scala
Ajax: Building HTML vs injecting HTML	ajax
Copy method fail due to memory	excel
Breaking a cell if it contains a newline character	excel
"""Matlab """"out of memory"""" error"""	matlab
call valang validator in MultiActionController ModelAndView method... possible? how?	spring
Hibernate CollectionOfElements EAGER fetch duplicates elements	hibernate
SharePoint setup best practices with ISA	sharepoint
in-house projects: to stable release or not?	svn
Hibernate bidirectional parent/child problem	hibernate
Tripping over NSValue, NSNumber & NSDecimalNumber	cocoa
What PHP framework to choose for a Senior Project	drupal
xls to text converter	excel
Can you install Qt-4.6.0-wince successfully?	qt
Practical use of futures? Ie, how to kill them?	scala
Best Matlab toolbox that implements Support Vector Regression?	matlab
Migration of Wordpress sites to a local WAMPserver, now the pages cannot be found	wordpress
"""Forcing """"drupal_set_message"""" messages to appear immediately?"""	drupal
Using Option all over the place feels a bit awkward. Am I doing something wrong?	scala
How do I find the correct case of a filename?	cocoa
Awk pattern macthing	bash
Rewrite rule-- If incoming request is not consist of certain characters then rewrite to other URL	apache
Good functions and techniques for dealing with haskell tuples?	haskell
Haskell: -fglasgow-exts should one avoid code that requires this?	haskell
argh - can't get spring to log sql	spring
Why QtCreator doesn't use QtPlugin?	qt
drupal: auto-generate video thumbnails	drupal
Hibernate Map Mapping Problem	hibernate
*** glibc detected ***  double free or corruption (fasttop):	qt
How can I make comments like on stackoverflow?	ajax
Looking for a skeleton application for a native macosx application (w/ installer script, notify icon, user preferences)	osx
Hibernate Error : Caused by: org.hibernate.NonUniqueObjectException: a different object with the same identifier value was already associated with the session:	hibernate
Remember window sizes and placement when unplugging and replugging second monitor.	osx
Excek VBA worksheet.names vs worksheet.range	excel
Qt Jambi: QAbstractListModel not displaying in QListView	qt
Visual Studio color theme	visual-studio
Oracle V-Limits (VARCHAR, VARRAY, etc)	oracle
Visual Studio Express any good ?	visual-studio
XlsIo DateTime Incorrect by about 4 years	excel
Implications of foldr vs. foldl (or foldl')	haskell
Query an XDocument for elements by name at any depth	linq
Why is ghc evaluating my infinite list?	haskell
D6: a homepage with only blocks?	drupal
"""Matlab: """"Too many Input Arguments"""" when not passing any!"""	matlab
Front page Featured Section	drupal
Manually inserting data in a table(s) with primary key populated with sequence	oracle
"""""""wget --domains"""" not helping.. what am I doing wrong?"""	bash
How do I format my oracle queries so the columns don't wrap?	oracle
unnecessary (?) Xcode warning	osx
hibernate composite key	hibernate
how can i add two projects..vs2008	visual-studio
Hibernate displaytag big lists	hibernate
Magento, 1 db field not saved	magento
Can't create foreign key	hibernate
apache-webserver-website publishing	apache
shared components throughout all projects, is there a better alternative than svn:externals?	svn
Terminal Command Mac Alter table SQLite3...	osx
Can you return an unevaluated function in scala?	scala
schema2ddl generates wrong datatype for YesNoType	hibernate
What is detached  persistance and transient object in hibernate ?	spring
How to make all AJAX calls sequential?	ajax
Merge Excel Files Into One	excel
Very slow compile times on Visual Studio	visual-studio
Migrating svn 1.4 repo's to 1.6, populating node origins.	svn
How can I use Cocoa's Accessibility API to detect that a window is brought to front?	cocoa
Can't access ResizableArray's protected method, swap, from subclass, ArrayBuffer?	scala
most effective row removal strategy for QStandardItemModel	qt
Installing Boost libraries on Snow Leopard	osx
How do you get a commenter's email address from a WordPress cookie?	wordpress
Solving Algebraic Equations Programatically	matlab
Deployment of custom content type, forms, cqwp, and xsl.	sharepoint
"""Set AWK delimiter to parse """"airport -s"""" output"""	osx
How to create a compiler Action for SBT	scala
Mac/Windows Switching	osx
What's wrong with this code logic?	wordpress
c:foreach using List: Must evaluate to a Collection, Map, Array, or null	spring
Can this be done using excel macos?	excel
MobileMe API Documentation	osx
Is the file hidden?	cocoa
Handling exceptions raised during method called via NSObject's performSelectorOnMainThread:withObject:waitUntilDone:	cocoa
What comparable Javascript function can reference a file like PHP's include()?	ajax
Exception error message with incorrect line number	sharepoint
How to use CurrentSessionContext/SpringSessionContext along with HibernateDaoSupport to intercept calls to getCurrentSession()	spring
qt soap client + ASP.net Web service	qt
Very slow merge with Subversion 1.5	svn
wordpress plugin to upload file directly to amazon s3	wordpress
Run a php app using tomcat?	apache
Why are there more files/hardlinks with the same iNode than the reference count shows?	cocoa
How can I use custom animations for onOrderOut in Core Animation?	cocoa
Screen resolution for programming	visual-studio
Newbie: What does jQuery.ajaxSetup 'beforeSend' do?	ajax
ORA-12638: Credential retrieval failed	oracle
Sort NSFileManager Results	cocoa
Linq PredicateBuilder - Multiple ORs - Newbie Q	linq
Help making my root directory not executable for CGI scripts	apache
Using Calender Store.	cocoa
"""NSSavePanel: Squelching the """"confirm replace?"""" dialog"""	osx
SPRING: How do you programmatically instantiate classes based on information passed from Flex UI	spring
"""Drupal 6: How can I """"turn off"""" a page?"""	drupal
"""""""Go To Definition"""" in Visual Studio only brings up the Metadata"""	visual-studio
So I compiled something with maven, now what do I do with it?	scala
Fetch posts starting with alphabet [x]	wordpress
How big of a security risk is checking out an svn project right into production site?	svn
Embedded Matlab: Problem with persistent variables.	matlab
How do I create a nice -description method that nests recusively like NSArray	cocoa
virtual machine player to os x	osx
scala - Getting a read-only sublist view of a List	scala
ORA-12514 after rebooting server	oracle
To understand Typeset for PythonPath	bash
function working on functions of Array[T] or List[T] or Iterable[T]	scala
Find all Folders in Root Directory	cocoa
PortalSiteMapProvider	sharepoint
How to perform Request destination in user page	drupal
vssettings	visual-studio
Does a newly produced mac application need to support 10.4, and can I both support 10.4 and prepare for 64bit?	cocoa
Saving nodes with a filefield	drupal
Mod-rewrite has revealed itself	apache
Megento Module action on ProductView	magento
I need to block my feed completly	wordpress
"""WordPress > Calling """"Recent Posts"""" widget via script from custom theme"""	wordpress
NSBorderlessWindowMask Window wont show NSPanels if not front most window	cocoa
Group by weekdays with Core Data	osx
Weird Error In My system.log file Over and Over and Over	magento
Don't mix Response.Write with AJAX, but what about UI.HtmlTextWriter?	ajax
data disappear after Item Update in Sharepoint with Office 2007 documents	sharepoint
Ajax: wait X seconds before load	ajax
Is there any performance difference between myCollection.Where(...).FirstOrDefault() and myCollection.FirstOrDefault(...)	linq
Is a variable in javascript available after loading an iframe and then going back to the page?	ajax
Redirecting Apache by Geo/Country IP	apache
Should I use TNSNAMES.ORA or tnsnames.ora?	oracle
Tablet PC SDK (1.7) Merge Module + VS2008 + Windows Vista?	visual-studio
In-memory mime-type detection with Cocoa (OS X)?	cocoa
Multiple Monitors with Visual Studio 2008	visual-studio
Urgent! Magento never run my module's sql install/update script!	magento
Qt Dialog Window Opens in Same Window	qt
NLS_LANG setting for JDBC thin driver?	oracle
Magento: What is the best way to extend Magento to add a class that is called on every page load	magento
IN Wordpress, .php files within the theme folder do not run, but return 404 error	wordpress
Thickbox problem - appearing at bottom of page	wordpress
MATLAB: dealing with java.lang.String	matlab
Magento: getting an attribute of a nav filter item	magento
Python Qt: Qprinter not defined	qt
dba_jobs_running: table or view does not exist when trying to access from procedure	oracle
Assistance with APACHE www.conf file correctly matching location?	apache
Hibernate casts BigDecimal instead of Integer	hibernate
Cannot get FeatureSpec structure to show up in the output when combined with JUnitSuite	scala
Binding a custom NSView: Does it demand creating an IBPlugin ?	cocoa
Inconsistent display behavior for Quick Launch menu in MOSS 2007	sharepoint
Where do you put cleanup code for NSDocument sub-classes?	cocoa
"""Any reason for having """"val capacity : Int"""" instead of """"val Int Capacity"""" in Scala"""	scala
drupal : how to restrict users to only be able to see one contentType	drupal
ODP.net Oracle Decimal Number precision problem when filling a dataset. Exception: Arithmetic operation resulted in an overflow	oracle
Anyone used CSS blueprint with Sharepoint sites	sharepoint
How to display the query executed by the drupal view	drupal
drupal: load view template on module activation	drupal
Assembla no longer free!! :(	svn
How best to debug a crash within objc_msgSend?	cocoa
HTTP error when uploading an image using default Flash Uploader in Wordpress	wordpress
"""Prevent """"MATLAB"""" folder in My Documents"""	matlab
F6 for compiling?	visual-studio
Should you register new extensions with Apple?	osx
Access X11 display from empty environment (bash)	bash
Cocoa: Measure time between keypresses?	cocoa
AnkhSVN Cannot Connect Due to Proxy	visual-studio
Unable to access Excel's Application.ComAddIns property if there are no AddIns installed	excel
How to define certain posts as featured posts in WordPress?	wordpress
Unfiltering NSPasteboard	cocoa
PHP's preg-match_all causing Apache Segfault	apache
How do you test an asynchronous method?	cocoa
Does anybody know if manisfest.xml (wsp) has an intellesense for Visual Studio?	sharepoint
Can we count MATLAB as programming language?	matlab
shut off htmlpurifier upgrade message	drupal
do i need to worry about concurancy with tomcat spring beans	spring
Spring: How to programmatically define FactoryBean	spring
How to Configure SSL over Database in Spring?	spring
Implementing custom Matlab functions in Simulink	matlab
Possible pitfalls on a multilingual Drupal site?	drupal
drupal 6: how to email users of tasks due (week b4, day before, and overdue)	drupal
stopping sharepoint workflow programatically	sharepoint
Ignore Hibernate @Where annotation	hibernate
"""Excel - """"File Not Found: VBA6.DLL"""""""	excel
SVN won't commit unversioned files even though they show up with svn status	osx
LINQ- Combine Multiple List<T>  and order by a value (.Net 3.5)	linq
Does Acegi/Spring security support getUserPrincipal()?	spring
Timeout setting of different browsers?	ajax
svn access to a https repository: username / password always being prompted for	svn
spring annotation configration issue	spring
Xcode gcc exit status 1	osx
springdoclet usage?	spring
If scala scaled well for Twitter, would jruby have done the same?	scala
Exception in JEE application Email Notification Pattern	spring
Does Scala's BigDecimal violate the equals/hashCode contract?	scala
ERROR: request not found in the TrackedRequests. We might be creating and closing webs on different threads.	sharepoint
qt/wxwidgets third party components?	qt
SharePoint and Office Open XML interaction question	sharepoint
what is the best way to backup subversion repositories?	svn
spring jdbc RowCallbackHandler nightmare	spring
In apache, if i go to https://mysite.com, the page itself is over https, but all images/links are http://. Is there way to auto rewrite the html so its all https://?	apache
Apache 2.2 ignoring VirtualDocumentRoot VirtualHosts?	apache
Drupal: customizing user registration workflow for communicating with another webapp	drupal
Magneto performance tunning	magento
DRUPAL: adding CCK image fields to other CCK fields	drupal
Visual Studio - New Filter instead of New Folder when using Create Project From Existing Source Wizard	visual-studio
"""Eclipse """"Share Project"""" by hand?"""	svn
How do you make a Menu Bar Item display how many rows there are in a table?	cocoa
Hibernate increment starting number	hibernate
Double question in excl strings?	excel
[Excel] Populate list via a bi-Condition	excel
How to remove, reinstall and/or find info about Visual Studio 2008 hotfixes?	visual-studio
Refactoring plug-in for Visual Studio 2003	visual-studio
SFAuthorizationView authorize: method does not work.	cocoa
Magento: Disecting the Default Theme	magento
Excel Word Wrap Problem after Macro	excel
How can I disable Theme Info module in Drupal when it takes up too much memory to access the admin>>modules page?	drupal
How to make an NSString path (file name) safe	cocoa
json problem (ajax uploader with zend)	ajax
plotting matworks logo and heartshape	matlab
Control Processes Started by Bash Daemon	bash
Automating builds from subversion tags	svn
Problems using MySQL instead of MySQLi	drupal
Making WP Templates	wordpress
my Magento Observer is getting in Endless loop	magento
What is the proper way to wrap this php loop around the javascript	wordpress
Matlab Simulink scope log or saved data	matlab
How do you put a normal control into an NSView?	cocoa
Connection hangs after time of inactivity	hibernate
Haskel dot (.) and dollar ($) composition: correct use.	haskell
Is Oracle RDBMS more stable, secure, robust, etc. than MySQL RDBMS?	oracle
"""[Haskell] Error """"No instance for (Num [t])"""" in Collatz function"""	haskell
How to use @sum with CoreData	cocoa
Qt: doesn't cause memory leak?	qt
"""""""Take this test to find out if you are..."""" type of module in Drupal?"""	drupal
MATLAB's hmmtrain assumes initial transition from state 1	matlab
Switch user and output variable contents	bash
Cascading updates with business key equality: Hibernate best practices?	hibernate
Locking Your Own NSPreferencePane?	osx
AJAX checker script, problem with redirect	ajax
Type Inference on Method Return Type	scala
error :php extension curl must be loaded	magento
Why won't my local Apache open html pages?	apache
Adding attributes to Q_PROPERTYs	qt
Is QT classified as a c++ library? If not a library, how would you classify QT?	qt
how to assign random energy E to every node and compare two nodes for maximum energy and also find distance between them?	matlab
Where are Visual Studio breakpoints saved?	visual-studio
Difference between Expression.Call overloads?	linq
detect svn changes in a .bat	svn
Customizing dockable windows in Visual Studio	visual-studio
Parser combinator not terminating - how to log what is going on?	scala
Why the comment's id are continues?	wordpress
How to use SBT (Simple Build Tool) with Google App Engine?	scala
Storing Feature Configuration within Sharepoint	sharepoint
hibernate Lock wait timeout exceeded;	hibernate
IQueryable  Where Extention Method with  Or's	linq
Call another program's functions?	cocoa
Magneto XML layout with custom modules	magento
stderr redirection to stdout	bash
Why isn't my sheet attached to the window it's run for?	cocoa
Identifiers in a Diamond Relationship between Tables	oracle
linq sql error : the text data type cannot be selected as distinct because it is not comparable.	linq
User Profile Import - more than on Search Base	sharepoint
Do PHP 4.4.9 based applications run on PHP 5.2.0 flawlessly?	magento
In Subversion what are best practices to modifying historical files?	svn
Eclipse IDE speed sluggish on Snow Leopard Macbook	osx
Lookup shell variables by name, indirectly	bash
hibernate, mysql, glassfish v3, and JTA datasource	hibernate
Drag & drop with .ui files	qt
How long does it take to create 1 million threads in Haskell?	haskell
"""Haskell newbie question: What is """"lifting""""?"""	haskell
How to serch by categories uisng trip_search	drupal
Magento : Converting currency before sending data to Google Checkout	magento
hibernate.properties classpath conflict	hibernate
How could predicate pushing on an inline view slow down a query?	oracle
Fonts in pdf documents screwed up when generated with latex (specifically, pdflatex) on mac osx.	osx
Scala isn't allowing me to execute a batch file whose path contains spaces.Same Java code does.What gives?	scala
xslt hyperlink, seperate the url and descption	sharepoint
Changing Excel 2000 pivot chart unit	excel
hibernate interceptors : afterTransactionCompletion	hibernate
OSX Application Bundle Working Directory	osx
Visual Studio 2008 Syntax Coloring Problem	visual-studio
Howto use mongoDB bindings for haskell.	haskell
Hibernate Entity sort column configuration	hibernate
Utilizing Sharepoint workflow functionality	sharepoint
tinyMCE & wordpress giving odd characters... tried combination of solutions...	wordpress
NSMutableArray count always returns zero	cocoa
Sync Services Client and Schema Xcode Project Structure	cocoa
CAML cannot reference Custom Properties in custom fields.	sharepoint
wordpress plug-in or anything that will allow us to edit the meta tags for each individual post?	wordpress
Sharepoint 2007 document management	sharepoint
Linq for NHibernate and fetch mode of eager loading	linq
Out of Memory Matlab Error	matlab
"""Creating a """"Universities Attended"""" Profile field/block (Drupal)"""	drupal
Problem computing a summation in matlab, seems so simple but i can't get it...	matlab
oracle: how do I get the sequence number of the row just inserted?	oracle
logging time using httpd.conf	apache
Qt dialog with no window icon	qt
Hibernate custom type definitions	hibernate
Linux shell scripting	bash
Should I use NSDecimalNumber to deal with money?	cocoa
linq help - newbie	linq
Self-extracting web environment	apache
team system unit testing and configuration	visual-studio
Making Excel functions affect 'other' cells	excel
Multiple calls with Simple Modal OSX Style Dialog	osx
Visual Studio Solutions Folder as real Folders	visual-studio
Hibernate, C3P0, Mysql -- Broken Pipe	hibernate
Making the Code check to see if the Text in a Text box matches any of the Strings in an NSArray.	cocoa
Qt doesn't find QStackedWidgets' slot setCurrentWidget	qt
Compatibility of Comet with current technology	ajax
VSTemplate with build action	visual-studio
Magento use own handle in widgets doesn't work	magento
plsql custom numeric format	oracle
Strongly typed dynamic Linq sorting	linq
Integrating External Sources in a Build	svn
No Runnable methods Error From Base Test class	spring
Extending Forms Authentication Timeout When Making AJAX Calls With jQuery	ajax
Giving The Root Row Of An Outline View A Different Background Color.	cocoa
Determining Oracle Database Instance	oracle
Do DDL statements always give you an implicit commit, or can you get an implicit rollback?	oracle
Drupal: passing variable from preprocess to template.php?	drupal
Why browsers sometimes render site bad?	apache
Bash open Firefox Window, then each subsequent window in tabs	bash
C++ class - Increment and decrement attribute every N milliseconds	visual-studio
Linq Select Certain Properties Into Another Object?	linq
Visual Studio Refactoring: Remove Structured IF/End If	visual-studio
Apache2 + RewriteMap + Python -- when returning 'NULL', apache hangs	apache
Multi-Dimension any()	matlab
MATLAB: Using ODE solvers?	matlab
Oracle, deleting many records with child tables	oracle
Error when converting XML from a CLOB column to XMLType colum	oracle
SharePoint (WSS) Authentication Across Multiple Domains	sharepoint
Fullscreen Key Down Actions	cocoa
Parsec: backtracking not working	haskell
Any existing way to make sure beans defined in spring xml are stateless?	spring
Web-based JSON editor that works like property explorer with AJAXy input form	ajax
Is there an easy way to convert HTTP_ACCEPT_LANGUAGE to Oracle NLS_LANG settings?	oracle
"""Making an NSTextField act like a """"microwave timer"""", store as NSNumber"""	cocoa
XMLHttpRequest object not being instantiated?	ajax
Best Pattern for AllowUnsafeUpdates	sharepoint
SVN Server running on Windows Vista in a Home Network, Accessing from Mac OS X	svn
Scala: How do I cast a variable?	scala
Loads of extra space at bottom of class in Visual Studio 2008 C# Express	visual-studio
does it worth to use MYSQLI_CLIENT_COMPRESS when the db is on another machine ?	drupal
Do you strip header files when shipping frameworks with your OSX application?	osx
MATLAB image corner coordinates & referncing to cell arrays	matlab
How to create an NSString with one random letter?	cocoa
AJAX - timed mySQL queries (please wait screen)	ajax
Is there a way to stop WYSISYG editor in wordpress from trimming out certain tags?	wordpress
hibernate cascade deletion	hibernate
Excel, 2 sheets, 2 columns, same value?	excel
Permissions Error Registering Assembly	visual-studio
QThread Not Starting	qt
Viewing repository information from within Eclipse, when code was checked out using svn tortoise	svn
disabling color correction in quartz 2d	osx
linq 'range variable' problem	linq
Display Link to Category in Wordpress?	wordpress
drupal  problem with creating word document files	drupal
What References Does Visual Studio Add When I Accidentally Click Add New Winform?	visual-studio
Error viewing csproj property pages in VisualStudio2005	visual-studio
"""Why """"avoid method overloading"""" ?"""	scala
Is it possible to forward ssh requests that come in over a certain port to another machine?	osx
Which wordpress forum plugin is best to use for a corporate site?	wordpress
What is Stream Fusion	haskell
CAML Query not ordering properly	sharepoint
making a GET request to a webservice from the playframework 2.0	scala
How to send js array via ajax?	ajax
VBA SQL Query Table Error problem	excel
Linq query built in foreach loop always takes parameter value from last iteration	linq
Hibernate: Clean collection's 2nd level cache while cascade delete items	hibernate
How to return javascript variable to Ajax?	ajax
SVN admin can create folders, but can't delete them	svn
How can I embed a WordPress blog into another site?	wordpress
Excel:  combobox listfillrange property pointing at a formula-based named range; combobox with a linkedCell, equals bugs	excel
Using svnversion with svn:keywords	svn
Linq To XSD at runtime.	linq
Missing Visual Studio features when running in 64-bit mode	visual-studio
Why does TortoiseSVN (1.5.3) try to merge 1-Head when I pull from trunk?	svn
Cant find the Error in this Php piece of code	drupal
Does Mongrel do IPv6 well?	apache
Any risks using Macports?	osx
DRUPAL: is it safe ? / cron.php ?	drupal
Oracle Resource Manager Plan Design	oracle
Changing NSApplicationIcon across a running application?	cocoa
Matlab: preallocate a non-numeric vector?	matlab
Using svn and .NET Winforms - Building Install Files Deletes _svn Folders	svn
How do I dispose of my own sharedInstance in Objective-C?	cocoa
[SharePoint] Publishing HTML Field Control Converts Relative URL to Absolute URL	sharepoint
SSIS Oracle Parameter Mapping	oracle
What are Microsoft's public symbol servers useful for?	visual-studio
SVN Doubt - VMWARE Image / Install / Hosted which would you pick?	svn
Finder item in some point	osx
Creating dynamic region content in wordpress as in drupal	wordpress
Bash Scripting General Questions (conditionals and variable passing)	osx
Can you do Logic Programming in Scala?	scala
Magneto discount  coupon code set but value is not subtracted  from subtotal...	magento
"""Scala programmer - """"should there be one obvious way to do it"""" or """"more than one way to do it""""?"""	scala
"""Only allow one entry per User in a List - ListReceiver """"Feature"""" for a List?"""	sharepoint
Hinky Oracle Connection (TNSNAMES.ora Help)	oracle
Bash Scripting - no output, no echo	bash
Magento - send newsletter subscription information as email	magento
Programmable transparent forward proxy	apache
Making a Checkbox Toggle The Dock Icon On and Off.	cocoa
"""How to unimport String """"+"""" operator in Scala?"""	scala
"""debuging """"register_activation_hook"""" in wordpress"""	wordpress
What would be the best place to start learning AJAX (I have Perl as a backend)	ajax
"""SVN: Is there a way to mark a file as """"do not commit"""""""	svn
Magento: Differences between an extension and a module?	magento
cocoa+ unmount removable storage	cocoa
How can a web application synch a folder of text files on the client's PC?	ajax
Tracking e-mails in outlook with excel	excel
ADODB.Connection undefined	excel
Favorite Bash Prompt	bash
Subdomain read domain session	apache
Hiding some user profiles temporary from search	sharepoint
client side spring	spring
In Oracle, why do public synonyms become invalid when a table partition is dropped.	oracle
Is there a wordpress plugin for creating an API from your site?	wordpress
QT creator Installation error? - Snow Leopard	qt
Mac font rendering on Windows	osx
Is there an easy way to integrate scaladoc into IntelliJ Idea?	scala
NSTableView - NSButtonCell Data Source type?	cocoa
What goodies are present in UNIX shells sans BASH?	bash
BASH scripts : whiptail file select	bash
Excel: Change multiple formulae at once?	excel
DefaultMessageListenerContainer not working with Websphere MQ	spring
"""making GIF animation from """"movie"""" command"""	matlab
Filtering A Tree Controller.	cocoa
What exactly does TypeSynonymInstances do?	haskell
Determining ManyToMany vs OneToMany using ClassMetadata	hibernate
"""In Windows, what makes qmake append """"d"""" on a debug target?"""	qt
Workflow with user selecting Destination doc library	sharepoint
How can I determine Objects in application context?	spring
show last 5 posts that have <!--more-->	wordpress
Setting the NSBrowserCell image using bindings?	cocoa
Drupal/Drush: How to bundle a project.profile within a project.make?	drupal
How can I get access to spring container?	spring
Strange Exception thrown using Dynamic Linq Entity Framework Query	linq
Deleting A Row From An Outline View.	cocoa
newbie question: what role does the indentation play here? and Why one indent doesn't work?	haskell
Does anyone have experience with National Instruments CVI and source control?	svn
Temporary text attributes causing massive slowdown	cocoa
QtScript: crash on 64-bit windows.	qt
Default News Feed on Visual Studio Start Page (C# Profile)	visual-studio
Primitive recursion	haskell
does ssl also encypt ajax posts?	ajax
Hibernate, GWT and Gilead: sessions, transactions and caches	hibernate
using RewriteCond, can i change how fast content is served to users in different parts of the world?	apache
Finding out what user Apache is running as?	apache
endian-ness of new macs - are all pc platforms the same now?	osx
0x800a03ec when calling Select on an Excel range (IRange). Range was returned from the worksheet's usedrange.	excel
"""Adding Thumbnail Image on """"Related Products"""" on the Backend of Magento"""	magento
"""Magento - Hide price and """"Add to Wishlist"""" link in Category product list page"""	magento
Correct Structure to check for Errors using NSError	cocoa
SharePoint Event when Permissions of ListItems have been changed ?	sharepoint
Why does Visual Studio debugging mode does not work properly (performing F5 when F11 was pressed)	visual-studio
SpringJUnit4ClassRunner initialize beans for each test?	spring
What could cause Visual Studio / C# error MSB3105: Duplicate resources	visual-studio
IDictionary is Linq friendly? C# 3.0	linq
http://stackoverflow.com/questions/643853/customaction-not-appearing-in-listview-web-part-for-splist-that-does-not-inherit	sharepoint
Visual Studio Tips on getting headers that are used in a given project?	visual-studio
Runtime error 1004: Application-defined or object-defined error	excel
Hibernate JPA Sequence (non-Id)	hibernate
If all my sql server database access is done thru stored procedures.....	linq
QProcess::setStandardOutputFile only creates 0kb File	qt
java.lang.UnsatisfiedLinkError: Native Library {____.dll} already loaded in another classloader	matlab
Regular expression with RedirectMatch does anything	apache
local variable inside  the loop issue	bash
Haskell: Writing text files and parsing them back to original format	haskell
Fetch iTunes album artwork without iTunes running	cocoa
Duplicating views	cocoa
wordpress: add the categories to a post rss title	wordpress
Qt4: QTableView mouse button events not caught	qt
Apache Timeout directive not working?	apache
Creating registerable Visual Studio packages	visual-studio
Oracle TIMESTAMP WITH TIMEZONE named zone vs offset	oracle
Give me awesome Visual Studio keyboard short cuts!	visual-studio
Updating your blog from a localhost version	wordpress
How come sqlplus not connecting?	oracle
Application crashing when talking to oracle unless executable path contains spaces	oracle
wxhaskell asynchronous updates	haskell
Is there option to have powerfull URL and Aliases in Drupal, not the poor one that I've found?	drupal
Hibernate Second level Cache <<net.sf.ehcache.hibernate.EhCacheProvider>>	hibernate
Automatic migratiion between different Persistent backends	haskell
Easiest way to extract the urls from an html page using sed or awk only.	bash
Getting the speaker audio signal and then streaming it out	osx
How to use native C types with performSelectorOnMainThread:?	cocoa
"""What does this Python code do:  shell=(sys.platform!=""""win32""""))"""	osx
QT, making UI that shrinks and expands	qt
How to access a field's value via reflection (Scala 2.8)	scala
"""Continuation monad """"interface"""""""	haskell
Magento; dispatch multi store	magento
Dynamically hiding columns in a NSTableView	cocoa
Apache worker MPM and Linux threads	apache
Favorite Visual Studio keyboard shortcuts	visual-studio
How would you put an Image next to a text cell for only parent rows in an outline view?	cocoa
read data into matlab from textfile	matlab
Why does hibernate-entitymanager-3.3.2.GA depend on hibernate-3.2.6.ga?	hibernate
Copy Protection (mac apps): most cost effective solution??	cocoa
spring vs ejb. can spring replace ejb?	spring
Spring-AOP	spring
Are Rank2Types/RankNTypes practical without polytype variables?	haskell
How would you make a checkbox delete a row in a table if checked (Cocoa) ?	cocoa
JQuery ajax error function is executed even if query is successfull	ajax
Integrating Visual Studio Test Project with Cruise Control	visual-studio
What's a good library to manipulate Apache2 config files?	apache
Warning: Ignoring excess mask dialog entries in:	matlab
Scala's Implementation of haskell last method	scala
How to place comments through the Comment Approval Process in Wordpress?	wordpress
Which version control tool is best sutiable to handle reflective or cyclic mergeing? SVN, Git?	svn
bit.ly links in wordpress twitter status updates leads to 404	wordpress
Another shell open when at server?	bash
bash: redirect and append both stdout and stderr	bash
Discrete Wavelet Transformation	matlab
Magento - Display Attribute Admin Title	magento
Guard is skipped when it should not be.	haskell
How to determine if currency symbol is to the left or right of a number on MacOS	cocoa
Filterable SPFIeldUrl in default view.	sharepoint
Cocoa NSArray/NSSet: -makeObjectsPerformSelector: vs. fast enumeration	osx
ReportViewer displaying black background in Print Layout mode	visual-studio
Oracle: How to create an element in a specific namespace with XMLElement()	oracle
"""Oracle connection problem on Mac OSX: """"Status : Failure -Test failed: Io exception: The Network Adapter could not establish the connection"""""""	oracle
How can I filter a product's availability using isSaleable attribute?	magento
Encoding Keyboard Command Onto Bash Script	bash
Has someone recent and trusted news about Linq to XSD?	linq
Concurrent sum	excel
error handling with spring + servlet spec	spring
Using j2ep on an apache-tomcat cluster - design help	apache
Matlab get file size	matlab
Why toInteger :: Int -> Integer is lazy?	haskell
Remove newline character from first line of NSString	cocoa
Return value of nth or last match	excel
Performance effect of enabling apache response time log directive	apache
Progressive Enhancement	ajax
Hibernate MappingException Unknown entity: $Proxy2	hibernate
Magento - Paypal Express 404 Error	magento
How do I create image roll over nav buttons in Wordpress	wordpress
Video streaming woes	osx
Hibernate/Spring: Persisting collections	spring
Capture console output for debugging in VS?	visual-studio
Errors in Windows Forms controls in designer view	visual-studio
Good Syntax Highlighter For Self-Hosted WordPress Blog	wordpress
SharePoint Visual Studio document upload Web Test fails with Connot close stream until all bytes are written	sharepoint
Batch Renaming with Bash	bash
How the Scala script that reads 5G log file from network drive should be modified in order to read last x lines (like 'tail' in Unix)?	scala
svn merge with revision not doing what I expect	svn
Linq2Entities / Linq2Sql - Comprehensive search...	linq
"""scala """"error: io error while decoding"""" """"with utf-8"""""""	scala
Clean up before closing the QCoreApplication.	qt
Sharepoint 2007 maintenance and staging	sharepoint
How to get Model errors in AjaxSubmit?	ajax
Oracle SQL Developer not responsive when trying to view tables (or suggest an Oracle Mac client)	oracle
Java spring database application won't quit reference to org.enhydra.jdbc.pool.PoolKeeper is still active why?	spring
Tool in Visual Studio 2008 for helping with Localization	visual-studio
Purposefully Slow Function	matlab
NSDateFormatter won't parse dates using locale settings?	cocoa
Appropriate VS Project for Multiple .Net Sites	visual-studio
Making a drupal database call using ajax	drupal
parsec-3.1.0 with custom token datatype	haskell
Bash Case menu - dynamic choices	bash
An RMIPRoxyFactoryBean factory in Spring?	spring
Override SPList.WriteSecurity behaviour?	sharepoint
Check each pixel for a specific colour (within a certain threshold)	matlab
Passing a native pointer to performSelectorOnMainThread's withObject argument?	cocoa
Is QHash::contains method case-sensitive or case-incensitive?	qt
how will you take only stored procedure backup in oralce 10g?	oracle
Primitive recursion	haskell
Which one of the java spring books to start?	spring
USB (PNY 4GB) suddenly appears empty - mounts, but name is strange, files not there	osx
Is there an easier way to add menu items to a wordpress navigation menu?	wordpress
Question about what I should have before Connect	qt
Global object for Javascript to interact with Safari plug-in	cocoa
is there any scala network library with actor model	scala
In excel automation, how to gracefully handle invalid file format error upon file opening?	excel
Setting nested object to null when combobox has empty value	spring
The Matlab equivalent of pyton None	matlab
Relational databases and OO languages	linq
Using MonadPlus in FRP.Reactive.FieldTrip	haskell
What stratagies are best for storing art assets in SVN?	svn
Keep QPixmap copy of screen contents using X11, XDamage, XRender, and other tricks.	qt
does spring provide 2 mvc platforms, grails and spring mvc?	spring
"""How do I write, """"if typeclass a, then a is also an instance of b by this definition."""""""	haskell
designing Panels without a parent Form in VS?	visual-studio
Apache/Tomcat site nesting	apache
excel workbook isolated storage	excel
mailto link sharepoint desgner	sharepoint
Zipcode to city/state look-up XML file?	linq
What's a good directory structure for large C#/C++ solutions?	visual-studio
What are your most-recommended Visual Studio perferences?	visual-studio
Where is the template file for the password protected page in wordpress?	wordpress
excluding commits by specific users from svn merge	svn
QSlider focus issue (Mac Leopard) with QApplication::focusChanged(QWidget*,QWidget*)	qt
Underscore before theme name	drupal
QT / thread event loop QTimer/Mysql queries	qt
EXCEL Formula or VBA To Extract Data Based on Another Cell's Data	excel
sorting variable multidimensional arrays	linq
Cannot pass message (or Call a function) using the outlet of a customized class	cocoa
Html checkbox change value in MySql	ajax
SPCrossListQuery fails to bring back results	sharepoint
Quicksort + Profiling	haskell
Does LINQ's ExecuteCommand provide protection from SQL injection attacks?	linq
Add new Entity to persisted Collection	hibernate
incompatible types found: required: default enums in annotations	spring
"""AJAX to do Real Time DB Polls like Twitter's """"Real Time Results"""" in Coldfusion"""	ajax
Does Fluent-Hibernate exist?	hibernate
Drupal: Staying Organized with Module Changes	drupal
Dynamic UI styling/theming	ajax
Flipping Quicktime preview & capture	cocoa
Reading annotation property in aspect	spring
Excel through OleDb shows numbers differently...depending on whether spreadsheet is open!?	excel
apache on windows virtual directory config help	apache
How to use scalax.io.CommandLineParser?	scala
Any idea for running Qt signals/slots over network?	qt
How to tell Apache, in reverse proxy mode, to intercept or trap 302 responses from backend server and redirect internally without sending 302 response back to client?	apache
hibernat sesson problem new	hibernate
Display os x window full screen on secondary monitor using Cocoa	cocoa
MPM Prefork Apache Uses Absurd Amount of Memory	apache
Scala: Is there a way to use PriorityQueue like I would in Java?	scala
Integration Test with Spring: Cannot convert value of type error	spring
Visual Studio Vs Visual Web Developer	visual-studio
Packaging multiple features into a single WSP solution file	sharepoint
Upgrading from SPS 2003 to MOSS 2007	sharepoint
hibernate OneToMany List ordering persisting but reversing?!	hibernate
svn create tag problem	svn
OSX - always hide certain files	osx
Matlab copy constructor	matlab
Comparing Two Arrays.	cocoa
How to write a proper null-safe coalescing operator in scala?	scala
Where to manage the most sensitive content you have under version control?	svn
Unique random number sequence using qrand() and qsrand()	qt
Howto import an oracle dump in an different tablespace	oracle
How do you get search capability similar to Spotlight or iTunes?	cocoa
"""Scala: working around the """"illegal cyclic reference"""""""	scala
calling user_save from within hook_init failing on Drupal6	drupal
spring ioc injecting conrete implementation of interface to test	spring
Is there a difference between installing mod_python via httpd.conf and conf.d in apache?	apache
Future posting with dateCreated in Wordpress via XMLRPC in Ruby	wordpress
How to programatically add an object to a bound NSMutableArray?	cocoa
Compiling QT-Creator with mingw	qt
How do I group similar catalog products (CD & mp3) on the landing page of my Ubercart store?	drupal
Why would the browser cache assets (images, js, etc.) while GETting but re-request everything after a POST + 302 redirect?	apache
How to hide AJAX HTML Editor Bottom Toolbar	ajax
In Java/Spring, how do you setup the hashmap to append the query string?	spring
Default value for PivotChart Report Filter/Page Field	excel
JQuery AjaxUpload and PHP Max File Size Issue	ajax
Which Visual Studio Color Theme?	visual-studio
breakpoints not working after installing valgrind	qt
How important do you think Progressive Enhancement is?	ajax
Validation Drop down on a condition	excel
Creating GUI application completely in QtScript, what is your opinion?	qt
Set timeout on jQuery .load	ajax
Magento layout related basic Questions ?	magento
Linq Stored Procedure Issue	linq
Same Port, but different DocumentRoots	apache
Automatically Compile Linq Queries	linq
Validate Emails with Bash	bash
Why use SysV or POSIX shared memory vs mmap()?	osx
Best way to select the id of the matching row with the most recent timestamp	oracle
PHP using too much memory	apache
I've a function updating database table using Spring's JdbcTemplate and for some reason there was exception that connection is read only u can not update any database related changes. How to resolve these problem?	spring
Keyword highlighting on selection in Visual Studio 2008	visual-studio
Anyone have commit notification hook script that will send email upon commit of codes?	svn
What is MACID ?	haskell
spring transactional cpool. Which one do I use?	spring
How do you add context senstive menu to NSOutlineView (ie right click menu)	cocoa
SET game odds simulation (MATLAB)	matlab
Data Classification:sizes of training and test vectors	matlab
QFileDialog: adding extension automatically when saving file?	qt
ETL , Esper or Drools?	spring
Magento: Adding a custom EAV attribute that autopopulates with its default value on entity creation.	magento
qsettings different results	qt
How to expose a constructor variable(sic!) as read-only?	scala
Sharepoint MOSS customised v's uncustomised	sharepoint
Odd Behavior With Copy/Paste Into FSI On Mac	osx
Memory Leaks - Formatting a String To Display Time, Each Second	cocoa
Dependency Injection problem with EntityManagerFactory + jpadaosupport	spring
lamda extension to combine lists	linq
Passing functions as arguements in Matlab	matlab
Problem managing session with multiple data sources	spring
How does Drupal provide an edit/review/publish model?	drupal
Apache BeanUtils.copyProperties is spilling too much log	apache
Is wordpress a good platform for webapp development?	wordpress
Codecharge Studio alternatives for mac	osx
"""Having """"Minimal Price"""" display issues within assigned category."""	magento
Linq: In what situation do you use linq?	linq
ajax displaying code instead of result	ajax
where does drupal store the actual content in the database?	drupal
Cross join (pivot) with n-n table containing values	linq
LINQ - Return Value From Field With A Max Value if No Rows Found	linq
Hibernate QueryException couldn't resolve property	hibernate
Is there a super-high-load (Ajax) chat script out there?	ajax
Controlling Hibernate's generated subselect	hibernate
svn stumbling blocks	svn
Real time video capture??	qt
Where is The Abandoned Cart Report Located in Magento?	magento
"""Does Linq has """"Difference"""" ?"""	linq
Enable anonymous Access (svnserv)	svn
"""DRUPAL: my back-end edit node page jumps up when I click """"save"""""""	drupal
BDC Paging	sharepoint
IKImageView and scroll bars	osx
*Simple* FLV player (no logo, no advertisement)	drupal
Best way to handle multiple NSTableView(s)	cocoa
"""QCalendarWidget as """"Pop-up"""", not as new Widget?"""	qt
SharePoint - Connection String dialog box during FeatureActivated event	sharepoint
MATLAB: comparing 2 columns content	matlab
Executing a method from another class in java(and more)	spring
How to work with assertEqual with parameterized types	haskell
Auto-wiring a List using util schema gives NoSuchBeanDefinitionException	spring
CodeRush for C# issues	visual-studio
Reference from UITableViewCell to parent UITableView?	cocoa
State Monad, sequences of random numbers and monadic code	haskell
svn revision number	svn
Activate Range, Allow Edit, Continue	excel
Outputing UTF-8 string on Mac OS's Terminal	haskell
"""VSeWSS """"Attach to IIS Worker Processes"""" grayed out"""	sharepoint
Does SQLDeveloper support executing scripts?	oracle
How do I save state with CALayers?	cocoa
Visual Studio shortcut for showing dropdown of availble Enum values for function argument	visual-studio
When to create Interface Builder plug-in for custom view?	osx
Hibernate cannot recover after socket has timed out	hibernate
Running PHP without extension without using mod_rewrite?	apache
Excel: getting the selected rows back	excel
getting the path of a application at runtime + cocoa	cocoa
Refactoring val to method results in compile-time error	scala
"""Wordpress """"Read more"""" is not working"""	wordpress
Whats wrong with my Url Mappings?	spring
Can I Omit <?php drupal_render($form); ?>	drupal
tortise svn icons not showing up under windows 7	svn
Transactional Design Pattern	sharepoint
AJAX Alert Box with visitor memory - any examples?	ajax
What can be improved on my first haskell program?	haskell
PHPIniDir broken under windows 7?	apache
x86 Remote Debugger Service on x64	visual-studio
Matlab engine VS libraries created by MATLAB Compiler	matlab
How to add ads to the end of RSS on wordpress?	wordpress
"""Drupal 6: How do I only call up """"events"""" by upcoming date?"""	drupal
Ajax-driven complex layout RIAs and mvc frameworks	ajax
ls Return Values	bash
Matlab - Neural network training	matlab
Avoiding boilerplace when dealing with many unrelated types	haskell
Can someone explain source (versioning) control to me?	svn
Ejecting a hidden volume	osx
hibernate and spring persistance problem.  Possible identity value not incremented?	hibernate
[OS X] What can cause dlopen: no suitable image found (can't map)?	osx
Powerbook compiler queries	osx
NSScrollView Bar not scrolling through NSTableView rows	cocoa
Why Visual Studio doesn't create a public class by default?	visual-studio
Is it possible to integrate javascript with flash/a java applet/some other plugin that can create a tcp connection?	ajax
SpringFramework3.0: How to create interceptors that only apply to requests that map to certain controllers?	spring
Rehsarper 4.0 - Renaming a class does not rename the file	visual-studio
First-order logic formula	haskell
Turn Matlab plot into image	matlab
Is there a way to change (delete) a standard phrase going after a single post in Wordpress?	wordpress
The Genuine Sieve of Eratosthenes -- algorithm used to generate primay numbers.	haskell
How can I safely port my wordpress blog to localhost?	wordpress
ORA-08177: can't serialize access for this transaction	oracle
Should I study Scala?	scala
How do I check for a tag's existence in a post in Wordpress?	wordpress
Sleeping actors?	scala
Why does Hibernate/JDBC/MySQL drop connections after a day or so?	hibernate
App crashes when updating an highlighted NSMenuItem	cocoa
"""Drupal flushing """"Page requisites"""" cache also deletes javascript files"""	drupal
Getting ASN.1 Issuer strings from PEM files?	apache
Run Macro to Update Cells	excel
Secure AJAX connection / null character SSL cert attack?	ajax
drupal: hide single taxonomy term in particular view display	drupal
Can you pass stdin into unix host/dig command?	bash
Awesome Visual Studio Macros	visual-studio
monitoring idle time during mac development os x	osx
Un-Recognized Selector Sent to Instance Error.	cocoa
Java library or code sample to parse CTXCAT query syntax (for Oracle CATSEARCH)	oracle
Sharepoint as a high volume information system	sharepoint
Spring hibernate query help	hibernate
How can I keep data in sync during deployment?	drupal
Can someone please tell me what AJAX really is?	ajax
MyEclipse HIBERNATE Does NOT Order Property Sets by ID?	hibernate
Using Linq Expressions to decouple client side from DAL (which is server side)	linq
Matlab multiplication of 2 vectors error	matlab
Linq Compiled Query using Contains (Like SQLs IN statement)	linq
What applications do i need to download to start developing apps using spring framework?	spring
Magento : How do i echo username	magento
"""How can I stop Visual Studio (both 2005 and 2008) from crashing (sometimes) when I select the """"Close All But This"""" option?"""	visual-studio
Reducing WAV sound file size, without loosing quality	qt
In Cocoa, what is the best way to change the cursor when hovering over a circular view?	cocoa
Best Visual Studio 2008 Debugging Tutorial?	visual-studio
undo redo with an auto delete mechanism	qt
Visual Studio Add-in not going away	visual-studio
What's the best FREE collaborative platform for 2/3 programmers?	svn
anybody konws gui dsl on scala?	scala
Second Frontmost App?	cocoa
understanding syb boilerplate elimination	haskell
Nokia E50 and mac internet sharing	osx
VS2008: Make a non-LINQed website LINQed	linq
"""display """"value"""" on edit text matlab"""	matlab
how to open a panel with new folder function by NSOpenPanel ?	cocoa
FxCop on build (Visual Studio 2008 Professional)	visual-studio
QMenu* << QAction* -- Help Me Write A Global QMenu Insertion Operator	qt
Can I install/update wordpress plugins without providing ftp access?	wordpress
Switching from Tomcat to Glassfish	apache
Why can't I reference a user defined type field when using nested queries?	oracle
QT4: Transparent Window with rounded corners	qt
Excel: filter table rows by specified column value	excel
Match URL link from input string	bash
Retreiving Values From Excel Merged Columns	excel
Get short user name from full name	osx
Using Mercurial, is there an easy way to diff my working copy with the tip file in the default remote repository	svn
spring batch insert using hibernateTemplate, JdbcTemplate	spring
Any good PowerShell MSBuild tasks?	visual-studio
What are the ways to run a server side script forever?	apache
Calculating displacement moved in Matlab	matlab
lost library when recompiling Obj-C project	osx
Why it is allowed to point to constructors parameters?	scala
AJAX slowdown because of virus scanners or active network filtering?	ajax
Python Qt: embedded html bug?	qt
How do you enable javascript in a WebView	cocoa
Protect against accidental deletion	bash
SharePoint 2007 navigation and removing its delay	sharepoint
Setting LinqDataSource bound DropDownList using URL querystring	linq
What messaging/communication programs can be embedded into Visual Studio?	visual-studio
Tools for inspecting .lib files?	visual-studio
MOSS SpNavigationNode.Children always empty	sharepoint
[Best Practise] Visual Studio Solution Structure for multiple deployable projects	visual-studio
Location Bar Doesn't Show Redirected URL	apache
Moveable type images not displayed	apache
BASH MySQL Query to Comma Separated File	bash
Best way to link Category to customized Modul	magento
(C++ QT) QList only allows appending constant class objects?	qt
SharePoint - Posting and Retrieving files Automatically via VBScript	sharepoint
Jquery ajax getting the XMLHttpRequest  state	ajax
Should I remove QDebug header for release?	qt
what advantages MATLAB has over SCILAB and vice versa ?	matlab
User authentication on Resin webserver	apache
Visual Studio: Stop copying DLL files during build without my permission!	visual-studio
Views/Flags relationship-argument puzzle	drupal
My O/R Designer keeps deleting the designer.cs file!	linq
Deleting QWinWidget	qt
round NSDate to the nearest 5 minutes	cocoa
Matlab multiple graph types inside one graph	matlab
Magento - Is it possible to feed IE6 a different template?	magento
What are your most important console aliases?	bash
"""How to fix """"user warning: ... cache.inc on line 109."""" from a Drupal site?"""	drupal
Mac libraries for audio processing/sound file splitting	cocoa
"""Haskell equivalent of Python's """"Construct"""""""	haskell
What Code Snippet Editor Do You Use?	visual-studio
Bash - Recursively Create Nonexistant Subdirectories	bash
Visual Studio projects with multiple folders	visual-studio
Pascal syntax highlight in Visual Studio ?	visual-studio
Getting failure detail on failed scala/maven/specs tests	scala
Matlab Piecewise Functions + Vector Manipulation	matlab
How do you programatically identify a stored procedure's dependancies?	oracle
Querying for svn revision suddenly seems slow (since svn 1.5 maybe?)	svn
scala event swing :: chicken or egg	scala
Drupal: Creating anchor only link with l()	drupal
How do i display non-validation errors in jsp with spring webflow	spring
SVN problem: What is the latest revision that still contained this code snipped?	svn
half-sine pulse shaping	matlab
Twitter notification ajax bar, how did they do it?	ajax
Do you have any recommended macros for Microsoft Visual Studio?	visual-studio
"""Treat '0',""""-1"""" as Null"""	hibernate
Learning Sclala.	scala
excel VBA horizontal alignment problems when using NumberFormat codes	excel
How do you make a row in a table view go slighly opaque if a checkbox in that row is checked?	cocoa
Bash insert a comma (,) after every third field of a variable or array?	bash
Magento throwing exception on save for missing store_id	magento
Modifying the pretty printer from haskell-src-exts	haskell
Discrepancies between “Mock” Database and “Real” database behaviours.	linq
LINQ: IEnumerable<KeyValuePair<SomeType, IEnumerable<OtherType>>>  selection	linq
"""Which is your favorite """"hidden gem"""" package on Hackage?"""	haskell
Which method of checking to see if a NSDictionary contains a particular key is faster?	cocoa
Views Exposed Filters as list of links instead of select	drupal
Is an NSMutableString in this case more efficient than NSString?	cocoa
"""Visual Studios Link.exe error: """"extra operand"""""""	visual-studio
How can I convert scala.xml.Elem to something compatible with the javax.xml APIs?	scala
`sbt package` results in huge war file - how to make it smaller?	scala
Cocoa development: malloc: free_garbage: garbage ptr = 0x18a15e0, has non-zero refcount = 1 error	cocoa
Index not used due to type conversion?	oracle
NullPointerException on merge()	hibernate
Record speaker output with Audio Unit	osx
NSString's initWithData:encoding: return type issue	cocoa
Add references to project when control dropped from Visual Studio 2008 toolbox	visual-studio
Understanding Lob segments (SYS_LOB) in oracle?	oracle
QGraphicsItem unselect redraw problem	qt
Flowcharting tool/add-in for Visual Studio	visual-studio
Favicon.ico on multi-domain sites?	magento
Drawing automatic graphs using dot in mac python	osx
Wordpress: How to set default (active) theme via script	wordpress
LINQ: Using AssociateWith and Distinct together	linq
How exactly JdbcTemplate with TransactionManager works together?	spring
Give away signs that a site is Drupal?	drupal
SharePoint 2007 Calendar - Remove Time	sharepoint
DB Index speed vs caching	oracle
CoCreateInstance without an AddRef()?	visual-studio
Scala: Can't catch exception thrown inside a closure	scala
HTTPS on Apache; Will it show Apache?	apache
DataGridView/ListView - Display in an Outlook style?	visual-studio
"""Why does running """"apachectl -k start"""" not work, but """"sudo apachectl -k start"""" does?"""	apache
Qt, text on a black and white screen	qt
spring binding formmultiselect	spring
With Haskell, how do I process large volumes of XML?	haskell
hibernate cascade question	hibernate
C# Ranking of objects, multiple criteria	linq
Communicating with users on other web pages	ajax
getStoreCategories() returns nothing	magento
₡urr€nc¥ i$ Ki₤₤ing Me!	cocoa
list directories containinf more than 1 file	bash
Creating a VS .Net 2003 property macro/variable	visual-studio
Using NSOperation for threading creates too many objects	cocoa
Disabling interstitial graphic when using cfdiv binding	ajax
drupal: getting nodeautoterm node ids from taxonomy ids	drupal
Removing contents of PlaceHolderPageTitleInTitleArea	sharepoint
How to make XMLHttpRequest  work over HTTPS on Firefox?	ajax
NSScanner - Scan Next Line into String	cocoa
How can i get around the same origin policy?	ajax
<security:custom-authentication-provider /> means?	spring
vectorizing loops in Matlab - performance issues	matlab
A light weight Scala fork join syntax	scala
sharepoint permition on apple computers	sharepoint
Hibernate hbm2ddl and Ms SQL Server: Long as column of numeric data type	hibernate
Hibernate list operation question	hibernate
Long-lived connections (asynchronous server push) with Apache/PHP/Javascript?	apache
line-end agnostic diff?	osx
Qt, Getting the text when QPainter::drawText() is called	qt
Using SVN in Windows (Wordpress plugin-repository)?	wordpress
Hide link to a view if it's empty	drupal
first level hibernate cache , modify record directly at DB	hibernate
Accessing a VSTO application-addin types from VBA (Excel)	excel
LINQ Anonymous Types + MVC Views Help	linq
Why do we use hibernate annotation?	hibernate
How to use NSURLRequest with non-static content?	cocoa
Relative / Root paths on apache / cpanel / php shared hosting	apache
Visual Studio 2008 Fatal Execution Engine Error (7A2E0F92)	visual-studio
Get Directory Path to 12 Hive programmatically	sharepoint
"""DRUPAL: order exposed filter items, be carefully it is not that simple (I cannot user """"Sort"""")"""	drupal
What is the most convenient way to stop an Ajax-object in prototype from swallowing exceptions?	ajax
OSX API Question: Where does BlockZero live?	osx
SPContext.Current.Web.CurrentUser returns misleading value	sharepoint
QAbstractSocket::UnknownSocketError	qt
Programatically enforce capitalization in Visual Studio 2008?	visual-studio
How to specify type for bulk list assignemets	haskell
Can I zip more than two lists together?	scala
QMetaObject Compiler explain?	qt
Get the Title of all posts	wordpress
MSExcel 2002 calling Web Services.	excel
Apache HttpClient making multipart form post	apache
What is a common idiom for converting between Integral types?	haskell
GAE JCache NumberFormatException, will I need to write Java to avoid?	scala
How can use the currently displayed node to filter a block-level view on that node's page?	drupal
Bundled Product add new option error	magento
"""Merge sort from """"Programming Scala"""" causes stack overflow"""	scala
Building Opensource QT for Visual Studio 2005/2008	qt
is it possible to change page before ajax?	ajax
"""Removing """"user-profile.tpl.php"""" but it doesn't revert to default view"""	drupal
How to get 64-bit binaries from GHC for Snow Leopard?	haskell
"""""""browser back"""" possible without reloading page (AJAX)"""	ajax
What php code do I need to get text from wordpress text widget?	wordpress
Can I inject an interface subtype in Spring?	spring
Leopard Terminal (and iTerm) Ignores Control Key Combos	osx
Is there a way to programatically enable a widget from a plugin in WordPress?	wordpress
Content type custom document information panel	sharepoint
Sql Query to XML document inside Drupal	drupal
"""What are pros and cons to use """"wordpress theme framework"""" instead blank theme?"""	wordpress
"""MATLAB """"bug"""" (or really weird behavior)"""	matlab
What does the NS prefix means?	cocoa
How to manipulate ajax loaded content?	ajax
Height of NSTextView with one line?	osx
Equinox (OSGi) and JPA/Hibernate - Finding Entities	hibernate
Authorize.net Wrong Merchant Type From Magento	magento
SPRING: What is AOP, Dependency Injection and Inversion Of Control in Simple English	spring
How does AOP work in Drupal?	drupal
Eclipse CDT on Snow Leopard cannot find binaries	osx
Insert Images to list	qt
Time Machine API / Command-line scripts ?	osx
MaskedEdit Extender lost data on postback	ajax
Where is the Attic in Subversion?	svn
How does one create product collections in Ubercart?	drupal
Dependency Injection into your Singleton	spring
Bash || within if []; block	bash
Using conditional statements inside 'expect'	bash
"""LINQ UpdateCheck on parent """"LastUpdatedOn"""" field while updating children"""	linq
why co-cocoa pr-programmers st-stutter...	cocoa
Visual Studio 2005 crashes on start-up	visual-studio
SimpleFormController help	spring
How do I create Cocoa interfaces without Interface Builder?	cocoa
Oracle optimizing query involving date calculation	oracle
command line connect to tcp port, read data, match pattern, print true or false	bash
How can I define multiple sessionfactory instances in Spring?	spring
"""Programatically trigger """"detect displays."""""""	osx
C# LINQ: Sequence Contains No Elements Error (but I want to check for null!!!)	linq
SharePoint: Why does a content deployment job customize all my master pages?	sharepoint
Visual Studio Performance Choice - ESXi or Vista?	visual-studio
Hosted subversion recommendations or suggestions	svn
unwanted leading blank space on oracle number format	oracle
To allow only localhost in Apache's 000-default	apache
Using Restrictions.disjunction over @JoinTable association	hibernate
Query about Apache (httpd) dumpio log entry for the Request body which is coming NULL on Tomcat side	apache
Best way to cache persistent data (e.g. code books) in Spring?	spring
jQuery lightbox plugin change apperance of my wordpress site	wordpress
Bash script executting su command	bash
Is pretty XStream serialization feasible with Scala?	scala
Binding type variables that only occur in assertions	haskell
Checkout one file from subversion	svn
Maximum size of Actor Queues?	scala
Generic Linq ordering function?	linq
How do you make a Text Label display how many rows there are in the table.	cocoa
Looping Code/Skipping Rows	excel
hibernate object vs database physical model	hibernate
Matlab object array method dispatching	matlab
Understanding / Modeling forumals from Excel.	excel
Why can't Visual Studio run on more than one core?  CPU at 25%	visual-studio
Accessing I/O Catalog Class Objects	osx
Have J style adverbs, forks etc been emulated via libraries in mainstream functional languages?	haskell
How to create an iPod-esque UISlider	cocoa
Qt: What unit-testing framework?	qt
Sharepoint: Calculated Column replace all spaces	sharepoint
Subversion: Fail update when there are conflicts?	svn
Run-time error '-2147352567 (80020009)'	matlab
Finding correlated values from second table without resorting to PL/SQL	oracle
"""Error """" Index exceeds Matrix dimensions"""""""	matlab
Wrap NSButton title	cocoa
Any suggestions for effectively testing AJAX enabled web pages using MSVS Tester Edition Tools?	visual-studio
Penalty of using QGraphicsObject vs QGraphicsItem?	qt
Using Haskell for sizable real-time systems: how (if?) ?	haskell
haskell: faster summation	haskell
how to set time in ajex slider control?	ajax
Different coloured fly out menu	sharepoint
What ORMs work well with Scala?	scala
Outlook Webpart showing only 1 mailbox in Sharepoint	sharepoint
Laying out overlapping rectangles	qt
app pool identity - farm admin	sharepoint
Compiling jasperreports automatically on change	spring
Qt Creator: “inline function used but never defined” – why?	qt
Extending spring's default component factory	spring
Applying additional aspectj around advice to a spring transactional method.	spring
VS2008 Windows Form Designer does not like my control.	visual-studio
Strategies for designing a database (being accessed by hibernate) which will have alot of archivial data.	hibernate
using BOSH/similar technique for existing application/system	apache
Why is Visual Studios Installer not picking up dependencies	visual-studio
SVN\Tortoise painfully slow	svn
Using Mercurial Locally Only with Subversion Server	svn
Disable NSToolbar customisation via window's toolbar button?	cocoa
Differentiating between P tags wrapping images and P tags wrapping text nodes in Wordpress?	wordpress
Tips for more elegant code with monads?	haskell
How to chain AJAX calls in Rails?  A series of calls to be executed, depending on the result of the first call.	ajax
Sharepoint Blog: lost join between categories and post when convert WebPart to XSLT	sharepoint
How do you make your App open at login?	cocoa
"""Proper way of """"shutdown"""" a spring context in J2SE"""	spring
putStrLn, type Char does not match [Char]	haskell
Not able to save composite foreign key	hibernate
How would you make a Status Item show or Hide a window when clicked?	cocoa
What are some of your favorite little known command-line tricks using Bash?	bash
Do you use any of the features in the various Visual Studio 2008 Team editions?	visual-studio
Serializing a JSon object using lift-json [scala]	scala
Hiberate: Collections of Collections	hibernate
Too many TIME_WAIT connections	apache
Are there alternative methods for saying 'next' in a pl/sql for loop?	oracle
Can a Scala program be compiled to run on any JVM, without having Scala installed on the given machine?	scala
how to detect that localhost web site is closed and then shout apache web server	apache
Custom spring scopes ?	spring
Shell Prompt Line Wrapping Issue	bash
huge svn checkout makes apache (dav_svn) consumed all memory on server - any tips?	apache
javascript - Want to access the contents of another domain with ajax?	ajax
"""In Sharepoint, what is the actual name of the page layout used for the """"Article page with with body only"""" layout option?"""	sharepoint
How to hide the Dock icon	cocoa
Spring Hibernates session issue with http request	hibernate
Getting a CGImage out of a PDF file	osx
HQL query equivalence: Why are them different	hibernate
Bash, argument list segment	bash
Cost of using repeated parameters	scala
QNetworkAccessManager/QNetworkReply with custom QTcpSocket?	qt
Creating a virtual, data-driven section of a Wordpress-powered site	wordpress
Adding sorting to a view on Drupal?	drupal
Need help changing Permalinks in Wordpress, I've tried everything..	wordpress
Visual Studio Context Menu Shortcut	visual-studio
"""Any """"fundamentals-oriented"""" example of NSScroller out there?"""	cocoa
Need Help With AJAX-Enabled WCF Services (Please Look @ System.ServiceModel in Web.Config)	ajax
online Control Property editor like control property editor in Visual Studio	ajax
Why are event-based network applications inherently faster than threaded ones?	apache
How to use objetcs as modules/functors in Scala?	scala
Sync SharePoint Sets with File System?	sharepoint
City selection on UberCart checkout menu?	drupal
"""Magento - change """"Catalog Input Type for Store Owner"""""""	magento
How do you make a Outline View Re-Orderable like a Table View?	cocoa
Visual Studio 2008: make ctrl-k, ctrl-n (next bookmark) stay within the same file	visual-studio
Mapping 2 vectors - help to vectorize	matlab
TinyMCE adds <pre> tag when inserting from Word	drupal
Magento: which catalog_product_flat I need to select from? and what is catalog_product_entity_datetime table?	magento
What's the best php / mysql emulator	apache
What's the smart way to implement OrderBy / ThenBy?	linq
? Structuring a Revision Control System (SVN)	svn
Which delegate method I should use to respond to clicks on a text field?	cocoa
SpringIDE and eclipse galileo 3.5	spring
Iterate enumerable object while debugging in Visual Studio	visual-studio
Which CSS framework causes the least interference with SharePoint?	sharepoint
Including eval / bind values in OnClientClick code	visual-studio
Theming for/with javascript?	drupal
Optimizing Sharepoint Search Crawling	sharepoint
Qt painted content goes lost	qt
prototype serialize returns function instead of serialized string	ajax
Is there a way to get types/names of an unknown db query without executing it?	oracle
Dynamically changing dropdown in excel.	excel
QTreeView stylesheet customization problem with scrollbar	qt
Visual Studio behaves strangely while debugging with breakpoint conditions	visual-studio
how to change a column's attribute without affecting the values already present?	oracle
Magento - showing review links & add-to-compare links on custom pages	magento
Visual Studio won't make debug DLL	visual-studio
How do you migrate CCK fields between environments in Drupal?	drupal
Qt Animation: Appearing & Disappearing Objects	qt
Which SharePoint 2007 features are not available to Office 2003 users?	sharepoint
Hibernate constraint violation/error rolling back	hibernate
Custom Class - IBOutlets Not Working?	osx
Updating frontend layout from a module	magento
"""Mac solution for """"safe"""" C/C++ Standard Library functions?"""	osx
Linq validation non nullable properties	linq
Scrolling different Widgets at the same time	qt
"""mingw spitting countless warnings about ignoring """"dll import"""" attribute"""	qt
SVN?  VSS?  Why is one better than the other?	svn
Sorting grouped nodes by taxonomy term	drupal
Batch Processing Image Files in Matlab	matlab
scala / lift example of form processing	scala
xUnit Testing Framework for Mac/iPhone	osx
Connect points and compute area	matlab
using REST webservices as a datasource for Lift ?	scala
Tidying up a list	matlab
Replace author url with different one	wordpress
Adding non-model nodes to an NSTreeController	cocoa
Add codebase as reference instead of copy Visual Studio	visual-studio
Rearrange ordering of blog posts vs content block?	drupal
Ajax: Definition vs Implementation?	ajax
Google analtyics is showing hundreds of 404s resulting from a null url	magento
SSLVerifyClient not asking for certificate	apache
Excel: Removing duplicates in one column while retaining highest value in the adjacent column.	excel
Magento - Programmatically added products don't show up	magento
Problem with WebKit rendering google.com (and a few other sites)	cocoa
Sporadic errSecAuthFailed (-25293) when accessing KeyChain with SecKeychainFindGenericPassword?	osx
Is LinqToSQL the same as Linq?	linq
Why can't I debug?	visual-studio
Qt linguist & google translate	qt
What kind of Plugin is the New Playstation Share Blog using | Wordpress	wordpress
Using Spring by Creating Multiple ApplicationContexts to manage bean life time - is this okay?	spring
Modeless MsgBox, Error trapping, .Find	excel
Access denied when blaming with ToroiseSVN	svn
Why use Hibernate/nHibernate?	hibernate
Collapse all Visual Studio toolbox regions shortcut	visual-studio
How can I identify a remote actor?	scala
On-demand eager loading	hibernate
Magento - Echo Attribute on Product Page	magento
Beginner question about XCode 3.1.1 and static libraries	osx
What are the options available for cross platform rich user interfaces development?	ajax
Q about AbstractApplicationContext.getBeansOfType() and getBean()	spring
Finding the Latest Post by Author	wordpress
Help Recommend Qt Opensource Project	qt
Simple question about text in Matlab	matlab
How can I make unlimited page widgets for wordpress?	wordpress
i want to use some Matlab functions via .dlls and use them in C#, pls Conduct which way i can doing that!?	matlab
How to make an iTunes like (playlists, library) left-sided (collapsible) navigation bar?	cocoa
QTextEditor returns quotes(	qt
Linq - what locale/collation it uses to compare objects?	linq
Accessing iSight programatically?	osx
Apache/PHP - alias outgoing URL	apache
NSFileHandle readInBackgroundAndNotify does not work	cocoa
Best solution for Java web based forms connected to Oracle plus JNI?	oracle
Qt4.5: Using event-loop based localsocket before app.exec	qt
Customizing SharePoint's NewForm.aspx, or creating my own form... thoughts?	sharepoint
Modifying Qt core components/widgets, best practices?	qt
Query to show images with recent posts in Wordpress sidebar/widget	wordpress
Selecting OSX SDK version in Eclipse and Makefiles	osx
Retrieve auto-detected hibernate dialect	hibernate
Ignore read-only class properties when using DataContext.ExecuteQuery<T>	linq
[MAGENTO] Index page is way too slow, what can I do?	magento
Your Favorite LINQ-to-Objects Queries	linq
Complete Haskore example	haskell
Nested Linq Min() crashes Visual Studio	linq
Magento - 2 or more observer on same event	magento
Views doesn't show checkbox fields where answer > 1	drupal
Adding deriving(Data) to standard types	haskell
xargs doesn't recognize bash aliases	bash
hibernate and netbeans application	hibernate
Stop Linq To Sql from Renaming properties of the DataContext after I rename them	linq
SPGridview single DataKeyName instead for multiple?	sharepoint
"""What's the """"functional way"""" to avoid passing state-choosing context down the call stack?"""	scala
Any way to rename image filenames?	drupal
Is it possible to curry the other way around in Scala?	scala
How can I resize an NSTextField to fit the text that it holds?	cocoa
batch create users?	drupal
bash: $[<arithmetic-expression>] vs. $((<arithmetic-expression>))	bash
Matlab - usage of knnclassify	matlab
Vsssc and Vssscc files - usefull for SVN?	svn
jdbcTemplate hangs on long update	spring
Bash script plugin for Eclipse?	bash
Connecting Two Bash Commands	bash
How can I rename (or even remove?) buddypress' wire-section?	wordpress
What's mean that Caused by: javax.validation.ValidationException: Unable to find a default provider ?	spring
Search and sort data from several files	bash
"""Ajax: Partial refresh of a parent page (update a div) from """"lightbox"""" window"""	ajax
Can Visual Studio 2008 work with Team System 2005?	visual-studio
Re-enabling JavaScript debugging in IE7 with Visual Studio	visual-studio
Update of of Composite Entity fails	hibernate
Enviroment variable within variable	bash
Can two different sites running on same host, share same database for storage and retrieval?	wordpress
writing video from webcam using opencv	osx
"""Re-Initializing """"ThisWorkbook.Path"""""""	excel
Bash or Python or Awk to match and modify files	bash
Magento Developers: Is Magento really -that- good?	magento
Rolling back foreign key relationships with Hibernate	hibernate
UNIX commands that support colours	bash
Review request and expiry notification emails for scheduled publishing pages	sharepoint
Is there any way to have the JBoss connection pool reconnect to Oracle when connections go bad?	oracle
Svn full dump (moving servers)	svn
Haskell Error: Couldn't match expected type `Integer' against inferred type `Int'	haskell
What is primitive recursion?	haskell
Magento - Create new user returns SQLSTATE[HY000] [2002] Can't connect to local MySQL server through socket '/var/lib/mysql/mysql.sock' Help?	magento
Graph/tree representation and recursion.	matlab
Looping Through Set Number of Posts in Wordpress, Then running same loop again on next set, etc.	wordpress
How can I access path variables in a URI template in the view (Spring 3/SpringMVC)?	spring
Use first post as start-page in wordpress	wordpress
Copy and paste cells if Duplicate columns , Excel Macro slightly different question	excel
.NET VS2005 WinForms: How do i drop a user control onto a form?	visual-studio
On QT widgets like DoubleSpinBox or ComboBox, how do i have custom right click menu	qt
How do I extend scala.swing?	scala
Javascript if(function_foo()) doesn't wait for function_foo() to complete	ajax
Binding NSSlider to control the zoom of an IKImageBrowserView	cocoa
Apache is not sending 304 response, if mod_deflate and AddOutputFilterByType is enabled	apache
Adding a rule that checks if the user's role has changed?	drupal
Resolving resx references	visual-studio
Is it possible to cache a whole website including start html page and startup with no internet connection?	ajax
How to iterate headers of sys.net.webrequest (ajax)	ajax
Gridview item preview using .net 2.0	ajax
Matlab: Print text in input field	matlab
Apple documentation a bit lite?  tips?	cocoa
Best practice with SharePoint feature deactivation	sharepoint
JasperReports JRBeanCollectionDataSource still confused...	hibernate
spring portlet MVC and request params	spring
How to average time intervals?	oracle
What are you favourite Matlab/Octave programming tricks?	matlab
PHP regex expression for the following...	wordpress
awk without printing newline	bash
DateTime Hex Format	sharepoint
Existential Quantification over Values	scala
NSBezierPath / Line Intersection / flatten	cocoa
debugger warnings while viewing StackOverflow?	ajax
Hibernate: batch_size? Second Level Cache ?	hibernate
How do I create NSColor instances that exactly match those in a Photoshop UI mockup?	cocoa
In cocoa, how can I darken everything displayed in a single NSView?	cocoa
Real-time history export amongst bash terminal windows	bash
Best way to post NSNotification with NSRect info?	cocoa
Find duplicate/repeated rows in hierarchical sql	oracle
Wrap stray text in <p> tags	wordpress
How can I sell a profile on magento?	magento
understanding hibernate first level cache	hibernate
Auto-sync Visual Studio's Class View	visual-studio
Race condition when calling FSDeleteObject	osx
SpringSecurity : always redirect logged in users to a page	spring
Magento : call a variable from customer’s shipping address in Onepage checkout, step 3 shipping method	magento
Can Visual Studio 2010 Beta be installed side by side with VS2008?	visual-studio
Linq to Xml: selecting elements if they're contained within an IEnumerable<XElement>	linq
Matching multiple data type constructors at once	haskell
Matlab postpones disp calls when doing demanding calculations why is that?	matlab
MaxValue Partition Name	oracle
"""Assume that WordPress is an almost-there CMS. What Plugins would you add to the 'core' to make it equal to """"Real"""" CMSes?"""	wordpress
How would I express this in Scala?	scala
xml excel realtive path issue	excel
Line of best fit scatter plot	matlab
spring & web service client - Fault Detail	spring
Excel: the Incredible Shrinking and Expanding Controls	excel
sort | uniq | xargs grep ... where lines contain spaces	bash
AW Blog (Create Bookmarklet Feature)	magento
NSPopUpButtonCell inside custom cell does not pop up when clicked.	cocoa
when close the top window ,how to let the focus to the next level window?	cocoa
Client Side Templates in javascript how to bind data	ajax
Docking Custom Task Panes	excel
Altering the style of an NSSearchField.	cocoa
Oracle 9i: Synonymed Table Does Not Exist?	oracle
Explanation of “tying the knot”	haskell
using the search box causes get_posts() malfunction	wordpress
Apple Event Handler Failure (Python/AppScript)	osx
Sharepoint SSL Web.Config access issue.	sharepoint
Getting WP Functions to Return rather than Printing Immediately	wordpress
Dealing with SQLException with spring,hibernate  & Postgres	spring
C stack overflow on Project Euler Problem 27	haskell
Update SubmitChanges() - does not update.	linq
"""what is the difference between ObjectQuery and """"var"""" ?"""	linq
@Range based hibernate validation checks	hibernate
Inline editing with AJAX - how do I create multiple editable areas on the same page?	ajax
display author URL in single	wordpress
Can MOSS 2007 integrate with multiple LDAP/AD stores?	sharepoint
Listing Apache Derby Active Connections	apache
Can't echo wp_count_posts('page')???	wordpress
Dynamic DNS on your own server	apache
Solve ODE without nested functions	matlab
Performance issue with QGraphicsScene::createItemGroup	qt
Sharepoint updating custom database	sharepoint
Replace important symbolic link ‘safely’	bash
override activexobject	ajax
excel string comparison is failing when it should not	excel
Cocoa Application Help	osx
Event Receiver for Document Library	sharepoint
How could I cache images that I'm pulling from a magento database through ajax?	magento
Install macruby to specific directory?	osx
spring session scoped bean value empty?	spring
Drupal: Associating grouping more than one CCK field.	drupal
Fully unrap a view	oracle
Guidance on creating non conflicting workflows	sharepoint
best practice for loading necessary JSON data: jquery's $(document).ready() hook? in the <HEAD> of page?	ajax
spring roo backup command lost my files	spring
Faster Insert Oracle Hash Cluster Table	oracle
Capturing title change event on SPWeb	sharepoint
A good way to send complex objects with ajax?	ajax
Parse players currently in lobby	bash
Whats the best, most simple ajax file uploader?	ajax
Excel Embeded If Statements	excel
Can pysvn 1.6.3 be made to work with Subversion 1.6 under linux?	svn
QThread issues. Crash after 2058 runs.	qt
Uninstalling partially installed XCode + iPhone SDK	osx
How To Prevent Tab Hell With Visual Studio And FireFox Debugging?	visual-studio
Using Google Table inside jqueryui ajax tab	ajax
Can't get wordpress feed to display full article...	wordpress
A think on sum(X, 1)	matlab
suPHP upgrade causing 500 internal server error	apache
Intelligent Keyword Searching	drupal
how to print just the popup window	drupal
Magento google products site html help	magento
MIDL generates the same file for /env win32 and /env win64	visual-studio
Is there any Wicket-like web framwork to use with Scala (not lift)?	scala
Silverlight 3 - RIA Services and LINQ	linq
Wordpress: Accessing A Plugin's Function From A Theme	wordpress
Linq - sum child field value when child records query ganareted by diffrent func	linq
or is not valid C++ : why does this code compile ?	qt
SVN : Get All Files From A Revision	svn
Hibernate Save strange behaviour	hibernate
Adding Event to YUI Rich Text Editor	drupal
can a magento adminhtml field depend on more then one field or value?	magento
How can I loop through posts as well as child pages to display them all by date in Wordpress 2.9	wordpress
How to add Remember me function at custom login box ?	wordpress
Why is [String] the inferred type when there are no lists visible in the code?	haskell
Python - Virtualenv , python 3?	osx
explain largestDivisible code from the Learn You A Haskell for Great Good tutorial	haskell
QtWebKit, QWebElement::setPlainText() problem	qt
mangento in postgres or oracle database ?	magento
My oracle listner to shuts itself down, what could be happening?	oracle
During Spring unit test, data written to db but test not seeing the data	spring
WordPress Post Date Changes On Update	wordpress
NSPredicate case-insensitive matching on to-many relationship	cocoa
Visual Studio Task Panel	visual-studio
How to create List from Range	scala
Programatically create web application & sub site	sharepoint
View more link should display next 3 records instead of displaying new page	ajax
Making an NSAlert be displayed when the User attempts to delete a row from an NSOutlineView when it has children.	cocoa
"""Mapping Hibernate """"Custom"""" Subclasses"""	hibernate
Load any file type  into matlab	matlab
How can you use ajax within an object to populate the object's instance variables?	ajax
Very slow response for Visual Studio 2005 Web Site Administration Tool	visual-studio
Apache2 isn't serving index.php	apache
bash loop between two given dates	bash
Refresh Using Ajax/PHP	ajax
Apache Caching within diffrent VirtualHosts	apache
hibernate one-to-one or component?	hibernate
Visual Studio or Eclipse - which one is better for Qt on Windows?	qt
How do I bind the enabled binding of a button to whether or not an NSArrayController has a selection?	cocoa
Why does ghci say that 1.1 + 1.1 + 1.1 > 3.3 is True?	haskell
Hibernate 2nd lvl cache	hibernate
Debug/Release diffrence	visual-studio
Differences Between Hugs, Yhc and GHCi	haskell
Fixing problems on a site that only breaks on IE7	drupal
"""Why does the Visual Studio IDE sometimes initialize the """"this.components object: and other times not?"""	visual-studio
C++ FileIO Pointer Leak error	osx
Does the order of cases matter in PHP switch statements?	drupal
QGraphicsView/Scene - multithreading nightmare	qt
IntelliSenss for XElements object with XML schema	linq
"""What are the various """"Build action"""" settings in VS.NET project properties and what do they do?"""	visual-studio
Using Git in a Company?	svn
Default type-parametrized function literal class parameter	scala
localhost != remote server	apache
Associating an image with a post in WordPress	wordpress
Including Sharepoint /pages/ in Import/Export	sharepoint
how can i move the cursor in insert mode in viemu (w/o using the arrow keys)?	visual-studio
How can I make properties files mandatory in Spring?	spring
Initialize NSMutableArray: [NSMutableArray array];	cocoa
Offsite backup from a timemachine capsule	osx
Where can I find a large AJAX loader .gif?	ajax
Hibernate Annotations generating query that produces SQLGrammarException	hibernate
Drupal: How do I modify my menu items' classnames?	drupal
Continuous Integration	visual-studio
Required Fields in Share Point data collection not throwing errors	sharepoint
Create block that displays preconfigured-term search results	drupal
Best way to implement realtime UI updates like SO's 'new answer' notifier?	ajax
Embedding Excel files in XSL-FO driven (Pdf)-Document Generation	excel
Getting started with Visual Studio 2008 plug-in / add-in development	visual-studio
jQuery is adding servlet name twice to URL	ajax
Creating a Quartz Composer Style interface	cocoa
Using scala actor framework as fork-join computation?	scala
Highlight NSToolbarItems	cocoa
Asyncsocket VS NSstream	cocoa
Is there an implementation of rapid concurrent syntactical sugar in scala? eg. map-reduce	scala
Deleting 'QNetworkReply *' returned by QNetworkAccessManager::post	qt
Jquery can't access original jquery objects from new div on ajx load event	ajax
What's so great about Scala?	scala
MATLAB: maximum pre-allocated size?	matlab
How do you authenticate against an Active Directory server using Spring Security?	spring
Easy way to get size of folder (ObjC/Cocoa) ?	cocoa
Why is Matlab Stateflow 7.7 not throwing errors on undefined variables?	matlab
MySQL InnoDB insertion is very slow	osx
command substitution but without breaking output into multiple arguments	bash
Adding slashes to the end of directories + more (htaccess)	apache
Visual Studio 2005: All projects in solution explorer expanded on first opening of solution	visual-studio
"""Best Language for an AJAX-driven """"Reputation Index"""""""	ajax
How does codeandtheory's live search work?	ajax
Adjust Sharepoint URL field length	sharepoint
Viewing Magento model data changes on before/after save event?	magento
How to do something like this in Scala?	scala
Piecewise Inline Function in Matlab	matlab
Understanding hibernate internals	hibernate
"""Scala puts precedence on implicit conversion over """"natural"""" operations... Why? Is this a bug? Or am I doing something wrong?"""	scala
Matlab Maximum Function Count Exceeded	matlab
lazyinializationexception with transactional annotation in messageconvert	spring
matlab: manipulating two linked matrices	matlab
Creating a quick look style zooming effect	cocoa
Mac: reloading document in Chrome or Firefox?	osx
How to set session variable skip_unusable_indexes to true in a PL/SQL package to speed up a table delete/insert?	oracle
"""nested CPS """"reset"""""""	scala
What files in Magneto have no purpose being in source control?	magento
Qt: Square constraint on window resize	qt
Where does the tomcat axis file server-config.wsdd come from?	apache
Can I start a thread by pressing a button in a cocoa interface and keep using interface while thread runs	cocoa
Is there an easy way to backup Oracle SQL Developer's User Snippets?	oracle
Java Execution Context Class Explain	spring
Resources to learn MacOSX development from Linux/Windows development point of view	osx
Visual Studio add-on gallery?	visual-studio
[SVN] Where did my committed file go?	svn
"""Integrating """"really simple history"""" with Rails"""	ajax
Qt: QImage always saves transparent color as black.	qt
NHibernate + JSON/Ajax Parent/Child Relationships? Why no workie?	ajax
How Can Wordpress Easily Provide A Voting and Commenting View For 5 Page Layout Possibilities?	wordpress
Program custom permission level	sharepoint
Obj-C object instance not recognized?	osx
can I update a label using ajax, instead of a textbox?	ajax
In Scala, why can't I partially apply a function without explicitly specifying its argument types?	scala
Editable content area for user with restricted access	wordpress
Function application: Why is $ used here?	haskell
why does the cocoa 64 bit garbage collector not release memory?	cocoa
Closed state of QDockWidgets not restored by restoreDockWidget?	qt
Linq (MIN && MAX)	linq
HTML/Javascript app that runs on the filesystem, security issue	ajax
Parent Contexts in spring based web-app	spring
Speeding up creation of NSDictionary from XML?	cocoa
query limit issue with php and mysql (drupal 6)	drupal
How do I keep an NSPathControl updated with the selected cell in an NSBrowser	cocoa
WSDL2Java tool error Apache CXF	apache
How to auto activate WordPress widgets? (New Widgets_API WP_Widget class)	wordpress
Itaerate over a list, returning the current, next and the element before current	scala
Can I develop a Mobile website using Drupal?	drupal
Collapsible member events in Visual Studio designer	visual-studio
Can two different wordpress blogs on the same server use a common theme folder?	wordpress
Why am I getting these Errors in the Console when Debugging in XCode?	cocoa
bash scripting..copying files without overwriting	bash
"""C++/CLI: linker gives """"resolved token"""" for win32 function"""	visual-studio
Preventing Visual Studio from building all projects when debugging one	visual-studio
How do I alias the scala setter method 'myvar_$eq(myval)' to something more pleasing when in java?	scala
Visual Studio (2008) mixed mode project depencies. C-sharp project depends on C++ dll, but C++ dll is not getting re-built	visual-studio
OS X - App doesn't show up in force quit.  How do I fix that?	cocoa
Add Principal/authority dynamically for anonymous user	spring
why does hibernate not force you to mark fields as virtual, but nhibernate does?	hibernate
"""AJAX-safe way to post-process / """"wrap"""" arbitrary web pages?"""	apache
Am I using histc wrong, or it this matlab's fault?	matlab
"""What makes Scala's """"operator overloading"""" good, but C++'s bad?"""	scala
Minimizing SpringLdap dependencies.	spring
Why do compiled Haskell libraries see invalid static FFI storage?	haskell
is cabal-install supposed to act this way?	haskell
running old mex file on new matlab releases	matlab
What are replacement and new practices from sh to Bash?	bash
Simple way to convert 00:20:40.28 (hours:minutes:seconds.split seconds) to seconds	bash
Location of view.properties in my proyect spring mvc jasperreports	spring
Grails formRemote redirects rather than to just call method	ajax
Using Oracle Database Migration Verifier	oracle
Is there an easy (idiomatic) way to convert a java.lang.reflect.Method to a Scala Function Value?	scala
Matlab: Magnetic fields calculated with biot-savarts-law	matlab
Oracle TNS names not showing when adding new connection to sqldeveloper	oracle
NSImage color shift on Snow Leopard	osx
Why Linq Preview for VS2005 doesn't create objects?	linq
How can I make a setup that makes my software require administrative priviliges while installation?	visual-studio
Minimum time between subsequent AJAX calls	ajax
- (void) processImage:(char *)image;  ---char* causes a memory leak?	cocoa
jpaTamplate how to autocommit...?	spring
modem.oqpskmod -> modem.oqpskdemod not same result	matlab
Can Web Parts in Sharepoint be moved outside of edit mode using drag & drop?	sharepoint
Epoch Time (Ticks since 1970) - Mac vs. Windows	osx
Programatically Publishing InfoPath Form As Site ContentType (Not Central Admin)	sharepoint
com.finder.desktopservices asks for admin password when copying files	cocoa
springsource tool suite (eclipse) tutorial?	spring
Qt Map Signals Based On Parameter Value	qt
Hide directories from listing, but don't disable directory listings.	apache
How do you set a title so that every row in a table has the title already typed in when you add a new row?	cocoa
Launching matlab remotely on windows via ssh?  Impossible?	matlab
RewriteRule checking file in rewriten file path exists.	apache
Mixing Visual Studio versions OK?	visual-studio
What's the difference between a CoreAnimation Layer Backed View and a Layer Hosting View	cocoa
instantiate object with reflection using constructor arguments	scala
Check whether application already running	cocoa
How to script scala directly in JSP pages?	scala
Are these two combinators already available in Haskell?	haskell
Magento; private/public filesystem layer	magento
spring ibatis mysql transactions	spring
How do I show the 'blog last updated' time in Wordpress?	wordpress
How to time-delay email deliveries?	drupal
Custom post metabox with upload file button	wordpress
"""What is a working copy and what does """"switching"""" do for me in Tortoise SVN?"""	svn
Disable MOSS auto import of colleagues	sharepoint
Counta behavior in countifs	excel
Save entire desktop state?	osx
php date() function displaying wrong time	wordpress
Unique hardware ID in MacOSX	osx
How can I add a hover class to an element?	ajax
URL Segment Support macosx 10.6	apache
Why is my comparing if statement not working?	cocoa
How do you overide a class that is called by another class with parent::method	magento
How can I use Tier Pricing with Configurable Products? (Magento 1.4+)	magento
Making an NSButton In-Active.	cocoa
Open Source SharePoint?	sharepoint
QWidget::find(hwnd) always returning 0	qt
Body Mass Index program in haskell	haskell
is svn-merge backwards?	svn
My linq-query doesn't work when adding the xmlns-attribute to the root-element in my XML-document	linq
Releasing under license: Do all files need the copyright statment?	apache
How to write eclipse rcp applications with scala?	scala
ajax calls being called too fast.	ajax
Easily Creating Dynamic Form/Controls Within Qt	qt
what is your favorite web app deployment workflow with SVN?	svn
Oracle works better with Windows or Linux? give your answer based on your experience.	oracle
how to add a menu into the Safari MenuBar or add a button into it's MainWindow?	cocoa
[Oracle] - Alternatives to Toad	oracle
Magneto as B2B - view 'company name' instead of first/last name	magento
Can I keep CruiseControl.Net's ccnet.config in svn, then have CruiseControl update its own config file when a change is checked in?	svn
Interpreting Visual Studio 2005 Threads Window	visual-studio
How do you remove inline styles in Wordpress?	wordpress
Running Magento for multiple clients Single Installaton Vs Multuiple installation	magento
Regex.MatchData returning null: why not Option[String]?	scala
Getting properies from SharePointWebControls	sharepoint
MOSS 2007 Crawl	sharepoint
Customizing Visual Studio's Intellisense	visual-studio
Spring: Same object, different validation	spring
Bash scripting, checking for errors, logging	bash
adding  #ifndef  #define  #endif breaks the compile	qt
changing Mac keychain Password programatically?	osx
IE doesn't wait for result of $.post(	ajax
foldl versus foldr behavior with infinite lists	haskell
What Cocoa/Core Foundation helper functions do you wish you knew about 2 years ago?	cocoa
Perforce blame	svn
bash, find files which contain numbers on filename	bash
Is there a built-in more elegant way of filtering-and-mapping a collection by element type?	scala
Hibernate template close transaction	hibernate
Rolling forward the archivelog and online redo logs to the restored database	oracle
Svnserve VS mod_dav_svn	svn
hibernate deletion problem please help urgent	hibernate
MODIFY COLUMN in oracle - How to check if a column is nullable before setting to nullable?	oracle
QT (4) equivalent macros/methods/constants for their Win32 API counterparts?	qt
Network Outage Causes Stored Procedure Querying Across DB Link to Hang Forever	oracle
svn rename problem	svn
How to change tint color of Cocoa's NSLevelIndicator?	cocoa
I want to allocate memory for 700 MB to 800 MB Image size	cocoa
Best reflection of extract-interface refactoring in subversion	svn
"""wordpress- have a specific type of """"page/post"""" as """"testimony"""". Possible? If so, how?"""	wordpress
MySQL Install: ERROR: Failed to build gem native extension.	osx
Stored Procedure & LINQ, Dmbl File unable to interpret the result set	linq
Can MatLab understand Java int datatype?	matlab
How can I stop PHP notices from appearing in wordpress?	wordpress
Magento, translate validation error messages	magento
Beans... what is it actually	spring
Simulated OLAP	oracle
SharePoint Survey, Ask same question n times based on answer to previous question.	sharepoint
To Ajaxify Or Not?	ajax
Is there a function to get the caption for an image in wordpress	wordpress
My under development local drupal site become very slow, how to solve?	drupal
Spring-modules caching not working... silently.	spring
Does it make sense to have more than one MethodSecurityInterceptor bean?	spring
More simple math help in bash!	bash
Linq output as an Interface?	linq
Map URL to MySQL databases	apache
Will an svn:external subdirectory sync with its HEAD revision upon every 'svn update' to the parent working copy?	svn
Upload An Excel File in Classic ASP On Windows 2003 x64 Using Office 2010 Drivers	excel
Oracle SYS_CONNECT_BY_PATH hitting 4000 character limit	oracle
Is there a way to peek inside of another Oracle session?	oracle
How can I make an NSOutlineView where some of the entires are buttons?	cocoa
Drupal and Ubercart - Add order that customer can pay for online? Bill customer's order without having them manually put it in their cart?	drupal
Is Haskell mature enough for developing commerical web applications?	haskell
Difference in website display depending on domain	apache
QFontMetrics::leading() returns 0	qt
Add a Blog to an Existing Webpage.	wordpress
Linq Help. int.Contains and int == iqueryable doesn't work.	linq
Magento: output an attibute as a link	magento
Should my Scala actors' properties be marked @volatile?	scala
VBA: Querying Access with Excel.  Why so slow?	excel
How do I get ghci to see packages I installed from cabal?	haskell
.Net Localization problem	excel
"""How to make Jetty dynamically load """"static"""" pages."""	spring
Can you add a big flash banner to the top of a Wordpress blog?	wordpress
Hibernate lazy initialization help	hibernate
Update all WCF Service References in one click (two clicks would be OK too!)	visual-studio
Spring: Programmatically use PropertyPlaceHolderConfigurer on none Singelton Beans	spring
Real life business case for using spring method replacement?	spring
Why is PartialFunction <: Function in Scala?	scala
Why does Spring's @Configurable sometimes work and sometimes not?	spring
Why is simulink data type conversion block altering the data when it should be typecasting?	matlab
MSBuild directory structure limit workarounds	visual-studio
Can entire page be developed out of ajax in asp.net 3.5?	ajax
Apache Mod_Rewrite RewriteRule strange behaviour	apache
MOSS 2007 Server hanging problem - AppDomainUnloadListener.RegisterSelf() & PublishingHttpModule.Init()	sharepoint
Finding errors / warnings in Visual Studio	visual-studio
How can I refresh core plot without returning from a method?	cocoa
Using change directory (cd) inside scripts - best practices	bash
spring+hibernate mapping class without xml	spring
Do Visual Studio 2005 testing tools contain tools for mocking?	visual-studio
Oracle 9i: Supposedly missing right parenthesis	oracle
Kill process after launching with AuthorizationExecuteWithPrivileges	cocoa
Is it possible to replace the Mac login screen?	cocoa
Does anyone have experience with clusters running on ClusterVisionOS?	bash
The RSS Feed of Wordpress blog goes wild	wordpress
How can I create a parser combinator in which line endings are significant?	scala
How to display unarchived custom NSView objects	cocoa
Can svn:externals be used while ignoring externals for that URL?	svn
Nested If Statements Returning zero if nothing entered in cell.	excel
Move Nice Menus to Just below the Title	drupal
Huge AboutIconData block in add-in file	visual-studio
PHP / Drupal, Session Storage and encryption	drupal
Running spring program inside application server	spring
Referencing beans in xml config created via Annotations	spring
Haskell: Parsing escape characters in single quotes	haskell
Getting plain HTML/CSS versions of Wordpress themes, no PHP?	wordpress
Show dialog/frame fullscreen on a second sceen sing QT/c++	qt
Sharepoint stripping HTTP Headers	sharepoint
upgrading drupal 4.7 to 5.2	drupal
Is this the correct step-by-step and organization for creating an SVN repo with multiple projects and vendors?	svn
What are zygo/meta/histo/para/futu/dyna/whatever-morphisms?	haskell
mac osx speech to text api How-to?	osx
Sharepoint OnWorkflowItemChanged before/after properties lists	sharepoint
Show price inc VAT for UK users only	magento
SQLPlus settings to generate tab-separated data file	oracle
Which hibernate adapter should I use to handle Lazy Initialization in BlazeDS / Spring integration projects with Flex?	spring
Commit changed files, added new files and omit some files to an external server in Subversion on Linux / Ubuntu	svn
Changing terminalinterface command after showing it on qt/kdelibs app	qt
Month navigation sidebar in blog section?	drupal
Howto Speedup Visual Studio(2005/2008) Toolbox initialization	visual-studio
Excel: Putting together two different complex formulas (Unique distinct list & Split)	excel
"""Drupal 6 Views: Constraining fields which are not the """"primary"""" node"""	drupal
How do I send a cross-domain POST request via JavaScript?	ajax
Way to check whether TinyMCE is active in WordPress	wordpress
Linking error: Undefined Symbols, lots of them (cpp cross compiling)	osx
problem filtering mousePressEvent with installEventFilter	qt
Optional Entity Attributes	oracle
MOSS FBA never asking for creds	sharepoint
Subversion ignore classes directory after its been added (and linked to src directory)	svn
AJAX XML reply node value iteration	ajax
scala Map filterKeys: Projection cannot be assigned to a Map reference	scala
Where to store database passwords in a spring application or use JNDI?	spring
Cocoa: Learn currently selected keyboard layout / input language	cocoa
Weird Qt bug (to do with properties editor)	qt
Javascript and AJAX, only works when using alert()	ajax
Dependency Injection mechanism	spring
Creating mdf file from sql script	visual-studio
Hibernate/mysql connection pooling	hibernate
Should I use ImageMagick or GD2 with ImageAPI in drupal?	drupal
ExpressionType.Quote	linq
Cross Platform Development - Go with a Cross Platform UI Toolkit or Native on Multiple Platforms?	cocoa
checkout svn+ssh with loginname	svn
Sharepoint User Favorite Documents	sharepoint
WHy can't I correctly parse this date string with NSDateFormatter?	cocoa
System command usage in Matlab	matlab
Cache: How to exempt just one block	drupal
Should repositories implement IQueryable<T>?	linq
Simulink: Specifying trajectory	matlab
Oracle: loading a large xml file?	oracle
Can MacOSX  group multiple NSApplications so they look like one?	osx
Hibernate session / transaction design	hibernate
Qmake project dependencies (linked libraries)	qt
Spring- How to use Springs Dependancy Injection to write a Standalone Java Applicaiton	spring
Why would NSWindow with NSTableView not resize?	cocoa
Get parent web not top level	sharepoint
Oracle: how to add a text node into an existing element	oracle
How do I get the 'size' of document stored in an oracle blob column in a readable form using SQL?	oracle
NSTask and which not finding my installed git location	cocoa
How was my WordPress site hacked?	wordpress
how to add filterclass into applicationContext?	spring
How can I stop cl.exe from terminating when a user logs out?	visual-studio
Recommendations, thoughts, tips and tricks, or peanuts on moving from wordpress to django	wordpress
excel group with hidden rows	excel
Sharepoint/WSS: helping writing xpath conditional expression	sharepoint
Qt::Tool window diassapears when application become inactive.	qt
How to relate between two classes with mongodb and spring?	spring
Is it normal to have a short delay after .innerHTML = xmlhttp.responseText; ?	ajax
"""Can I send """"batched"""" INSERTs to Oracle?"""	oracle
Is Haskell, truly pure (is any language that deals with input and output outside the system)?	haskell
IE not updating display after callpback pane updates the DOM	ajax
How do I authorize users on Telligent Community Server 2008.05 into another site?	drupal
What Subversion distributions are suitable for an enterprise	svn
Compiled Matlab: application hangs at the end	matlab
Running Visual Studio in Parallels for mac - problem with debugging sites lying in os x	osx
Can't copy or paste text in Cocoa after deleted edit menu item	osx
MS Access & Excel: Turning a query with dynamic parameters into something useful	excel
Determine if NSNumber is NaN	cocoa
is ther a drupal function to jump out of the page rendering process and return a page not found?	drupal
View Content of Deleted File Svn	svn
What does ${2:-${1}} mean in Bash?	bash
How to batch delete using bulkUpdate	spring
cck remote file (image) field - I want to keep the cached copy of the image when the node is deleted	drupal
Scala: Exposing a JDBC ResultSet through a generator (iterable)	scala
Visual Studio IDE layout tips	visual-studio
Is it safe to manipulate objects that i created outside my thread if i don't explicitly access them on the thread which created them?	osx
Overcome Wordpress Memory Exceeded Limit, WITHOUT changing server's limit.	wordpress
PortalSiteMapProvider causing excessive SPRequest objects	sharepoint
Excel VBA: Copy rows from another workbook, but just the function results	excel
Converting vector image to Quartz 2D code	osx
Use HTTP Auth only if accessing a specific domain	apache
PHP: Iterate through folders and display HTML contends	wordpress
McAfee deletes code from VBA module	excel
Create WebApplication with Drupal: development steps...	drupal
Get visible rectangle of QGraphicsView?	qt
Visual Studio reference x64 GAC	visual-studio
Display separator in Sharepoint AspMenu control	sharepoint
How to configure spring HandlerExceptionResolver to handle NullPointerException thrown in jsp ?	spring
Idiomatic, classy, open-source examples of Cocoa Interfaces?	cocoa
"""Why have """"while(1);"""" in XmlHttpRequest response?"""	ajax
Cocoa: Quartz, Core Graphics, Context vs View. Oh My!	cocoa
"""Haskell: can't use """"map putStrLn"""" ?"""	haskell
Stop Linq2SQL using Named Pipes?	linq
good combination of a c++ toolkit/library, cross platform db (not necessarily sql)	qt
How to handle XML Character reference in scala?	scala
Excel 2000 VBA: Errors Raised within Class Debug As If Raised at Property Call	excel
Need to increase PHP memory_limit for specific directory NOT entire server	wordpress
exception generated with qtconcurrent and calling QTime:currentTime	qt
What folder should my application write its launchd file?	cocoa
Comparing Mac's and Unix manuals?	osx
Create subdomain upon user registration	apache
Bash alias of an svn command piped to awk	bash
Oracle deadlock detection tool	oracle
Random line break showing up when .load() results display on page	ajax
How to get notifications of NSView isHidden changes?	cocoa
ConstraintViolationException VS DataIntegrityViolationException	spring
MS Access Reporting - can it be pretty?	excel
How Do I Programmatically Check if a WordPress Plugin Is Already Activated?	wordpress
How to update a postgresql array column with spring JdbcTemplate?	spring
Why doesn't git-svn use the Subversion repositories UUID instead of its URL	svn
Problem adding item to sortable list	ajax
WordPress: Is it possible to make one particular post always on TOP on blog.wordpress.com?	wordpress
"""AJAX leading to more """"chattiness"""""""	ajax
In AJAX how to retrive variable from inside of onreadystatechange = function ()	ajax
RowNum vs Row_Number	oracle
Will installing the Visual Studio 2010 +Oslo CTP screw my Visual Studio 08 install?	visual-studio
Mail Message Link Handling	osx
How do I override NSError presentation when bindings is involved?	cocoa
Question about QThread implementation	qt
capture types of varargs parameters	scala
osx mysql gui with plain text output?	osx
disabling Drupal's CSS/JS aggregation for admins	drupal
QDockWidget - remove handle	qt
obtain current svn revision in webapp	svn
Show/hide QDockWidget?	qt
gprof reports no time accumulated	osx
ODBC connect with propritary driver/Excel Trust settings	excel
Why would Spring's HibernateTemplate's loadAll() method generate updates for each row?	hibernate
web toolkit that does all of this?	ajax
Code template's indentation is buggy for code behind files in VS2005?	visual-studio
using subversion with a really really big site	svn
Importing selective data using impdp	oracle
Replace (translate) one char to many	oracle
How to programatically get current battery level with COCOA	cocoa
MATLAB runs out of memory during program execution	matlab
How to keep database connect alive?	ajax
What are the precise rules for when you can omit parenthesis, dots, braces, = (functions) etc?	scala
drupal what if we have designed a content type with existing fields	drupal
Is it bad practice to send an  actor a message from something which is not an actor?	scala
dynimically created DOM can't hold up in cache	ajax
Ajax Toolkit ReorderList Two components with the same id 'componentid' can't be added to the applicaiton	ajax
Resources Of Macintosh Development	osx
Excel Interop Updating Formulas	excel
OSX Security Framework NameAndPassword sample application	osx
Getting started with Visual Studio Designer	visual-studio
Creating an admin url for Magento that is admin.magentostore.com (not /admin)	magento
Why does my nib's window close immediately?	cocoa
Convert Option[Object] to Option[Int] Implicitly	scala
QT QImage pixel manipulation problems	qt
adsense iframes create new sessions on my server	apache
What is the relationship between unboxed types and strictness?	haskell
Modify an Excel sheet from Matlab	matlab
Remove VSMacros80 directory	visual-studio
Creating Site Templates from MOSS publishing sites	sharepoint
Linq - Casting IQueryable to IList returns null - WHY?	linq
Ajax won't get past readyState 1, why?	ajax
FILTER BY ATTRIBUTE MAGENTO	magento
NSTask returning HTTP Headers	cocoa
Import ITK/VTK into Matlab or Matlab into VTK/ITK environment?	matlab
Sharepoint refine results control only uses the current pages values.	sharepoint
scalar subquery in if statement Condition in PL/SQL	oracle
How does [UIView beginAnimations] work?	cocoa
LINQ: Using INNER JOIN, Group and SUM	linq
[super viewDidLoad] convention	cocoa
Oracle Floats vs Number	oracle
Hibernate/JPA - annotating bean methods vs fields	hibernate
Why can't I select symbolic links in NSOpenPanel?	cocoa
Explain Plan for Query in a Stored Procedure	oracle
How do I use Spring's IdToEntityConverter to do my Entity Type Conversion during form binding?	spring
Magento: Fixed shipping cost BELOW certain basket price.	magento
resolving svn binary conflicts	svn
Migrating Wordpress to another host: Can't login b/c it's confused about the host!	wordpress
Timing the Release branch	svn
How dangerous is this sql query?	drupal
What does the parantheses signify in (x:xs) when pattern matching?	haskell
Code in NSTimer prevents automatic sleep	cocoa
How do you add html/styling to the author profile on wordpress?	wordpress
Parallel Matalb and logging	matlab
help with selecting rows using awk	bash
Intermittent Problems loading type	sharepoint
Does ClearCase fit our development process?	svn
stsadm differential backups when directories are renamed?	sharepoint
help on integrating oracle BI into existing application	oracle
w3Schools gives some basic example for web based languages is there any kind of equiverlent for Studio Basic?	visual-studio
Linq to Sql - Set connection string dynamically based on environment variable	linq
MAtlab combining edge region back into image	matlab
List potential applications that could open a file	osx
Why does Apache return a 503 error for ant's get task, but not for my browser?	apache
spring security integrate with facebook connect	spring
bash/mysql complains about ) character	bash
How Can a Plugin Hijack a URL in WordPress?	wordpress
Excel Formula Null Value	excel
Filter linq list on property value	linq
"""The prefix """"security"""" for element """"security:http"""" is not bound"""	spring
How do I remember which way round PRIOR should go in CONNECT BY queries	oracle
"""Grep with """"half""""-exact match"""	bash
Retain cell address when sorting list	excel
Returning redirect as response to XHR request.	ajax
Using $@ properly (BASH)	bash
How do typeclasses and modules interact?	haskell
Mysterious cosmetic Visual Studio Editor issue	visual-studio
How to match newlines with Alex/Haskell	haskell
Curve Fitting	matlab
resizing an NSPanel to fit a dynamic NSMatrix and a button	cocoa
Writing MS Word 2007 XML	wordpress
Haskell, HDBC, ODBC, MySQL and Mac OS X	haskell
Hibernate/JPA/HSQLDB Enum issues...	hibernate
"""MS Access 03 - muliplte """"ifs"""" in one field of update query's criteria??"""	excel
How does 'get' actually /get/ the initial state in Haskell?	haskell
High performance product catalog in asp.net?	linq
"""Why would """"/id"""" as a HTTP GET parameter would be a security breach ?"""	apache
Linq OrderBy against specific values	linq
Carbon development on intel based mac	cocoa
Displaying code snippets in Sharepoint wiki	sharepoint
ReSharper sluggishness	visual-studio
Why do processes spawned by cron end up defunct?	bash
short way to breakOut to specific collection type?	scala
Sharepoint, Create View, Filter Properties	sharepoint
NSTableView -setDataSource not working when triggered by FSEvents	cocoa
"""Did you try Doloto """"AJAX application optimization tool"""" ? have any comments/concerns about?"""	ajax
"""Excel Prefixcharacter in C# with OLEDB causing """"Data type mismatch in criteria expression"""" error on UPDATE"""	excel
Is it possible to see definition of Q_SIGNALS, Q_SLOT, SLOT(), SIGNAL() macros? (Qt)	qt
SharePoint, WCF and Anonymous Access	sharepoint
File Structure / Architecture for AJAX Site?	ajax
Excel Interop Formatting Issues	excel
Spreadsheet: Count Repeated Values In A Column	excel
Help me understand FFT function (Matlab)	matlab
Oracle Documentation Generation Tool.	oracle
hibernate: LazyInitializationException: could not initialize proxy	hibernate
Set session time out limit for magento frontend	magento
"""Excel Interop """"FindAll"""" Method"""	excel
Matlab interview questions?	matlab
Does oracle allow the uncommited read option?	oracle
Change default author in local svn repo	svn
Matlab Simulation: Point (symbol) Moving from start point to end point and back	matlab
Control.Monad.State found in multiple packages haskell	haskell
Simulink sim of rician channel ber process	matlab
"""How do I Suppress """"PL/SQL procedure successfully completed"""" message in sqlplus?"""	oracle
hibernate foreign key	hibernate
How Do I Loop Through An Excel Spreadsheet With VBA, Paste A Value To A Website Form Then Extract The Result Back?	excel
What is [] (list constructor) *really* in Haskell?	haskell
PyQt, Qt, one event handler working with many items	qt
htaccess Redirect to same file, but display different URL without having to change internal links?	apache
Visual Studio solutions, do you nest them?	visual-studio
Where is the debug class path in netbeans / where does the spring config XML file go?	spring
QT 4.6 release date	qt
wp_redirect acting weird. requires die() afterward?	wordpress
Haskell: difference between . (dot) and $ (dollar sign)	haskell
Where to start with Google Reader as an API?	wordpress
Casting an mmapped ByteString to other types?	haskell
How to make a transparent NSView subclass handle mouse events?	cocoa
Is fine grained control of aspectj-autoproxy possible in spring ?	spring
"""SharePoint Site Design & Implementation: """"Online Manual"""""""	sharepoint
Haskell's Text.Regex.subRegex using TDFA implementation?	haskell
Downloading invoices (PDF) does not complete.	magento
Does Matlab handle USB communication?	matlab
QGraphicsView and QGraphicsItem: don´t scale item when scaling the view rect	qt
"""is there a wordpress """"lightbox"""" type of  plugin that works on the iPhone  ??"""	wordpress
Massive URL Change	apache
How do I let my DBA pause and resume a stored procedure that is updating every row in a large table?	oracle
Magento - Submit anf get variables between 2 blocks	magento
"""VS.NET """"watched"""" objects and recursive depth"""	visual-studio
Locating bundles by identifier	cocoa
lists searches in SYB or uniplate haskell	haskell
Visual Studio 2005 - 'Updating IntelliSense' hang-up	visual-studio
If text file is NOT empty, email me	bash
Working out which cell Vlookup refers to	excel
Sharepoint features, custom aspx pages at various site levels	sharepoint
Hibernate Mapping Through Another Entity	hibernate
Magento - Difference Between Import All Products/import Product Stock?	magento
Mac Console paste generating trash text	osx
The Microsoft.VisualStudio.Data.Interop.IVsDataProviderManager service could not be found.	linq
How would be a functional approach to shifting certain array elements?	scala
Would ReadyBoost have an impact on Visual Studio 2008?	visual-studio
"""Why would clicking """"View All Site Content"""" generate an error?"""	sharepoint
Different i18n in spring according to url	spring
Bash loop command until file contains n duplicate entries (lines)	bash
Where are project level imports stored in Visual Studio 2008?	visual-studio
Persisting large files with Hibernate Annotations	hibernate
UIViewController vs. UIView - which one should create subviews?	cocoa
hibernate - uniqueResult silently fails	hibernate
"""How can I set a """"hidden"""" attribute for text inside NSAttributedString?"""	cocoa
console application - object model - database persmission	sharepoint
Matlab Simulink: Transfer Function	matlab
Appened to /etc/apt/sources.list	bash
List wordpress sub-pages as drop-down list in navigation	wordpress
em.persist seems doesn't persist data on postgreSQL db	spring
Bash (Mac): edit file and some if commands.	bash
How can I access the ApplicationContext from within a JAX-WS web service?	spring
QDialog doesn't accept text input if modal	qt
Symbolic Math in MATLAB, solving simple integration	matlab
Svn ignore versioned on update	svn
